〒	(ゆうびん)
0	(かんすうじゼロ)『(まる)
る又	るまた
阿	(ア)(オ)〜(おもね・る)(くま)(ほとり)(あず)(あわ)(おか)(きた)(な)
嗄	(サ)〜(か・らす)(か・れる)(しゃが・れる)
哀	(アイ)〜(あわ・れ)(あわ・れむ)(かな・しい)
埃	(アイ)〜(ほこり)(ちり)
欸	(アイ)(カイ)
挨	(アイ)〜(ひら・く)
啀	(ガイ)〜(いがむ)
皚	(ガイ)(ギ)(ゲ)(カイ)〜(しろ・い)(さむ・い)
癌	(ガン)
矮	(ワイ)(アイ)〜(ひく・い)
藹	(アイ)
靄	(アイ)〜(もや)
艾	(カイ)(ゲイ)〜(もぐさ)(よもぎ)(おさ・める)(か・る)
隘	(アイ)(ヤク)〜(せま・い)
碍	{礙}碍。(ガイ)(ゲ)〜(さまた・げる)
愛	(アイ)〜(いと・しい)(あ)(あし)(え)(かな)(まな)(めぐ)(めぐみ)(よし)『おしむ『かなしい『めでる
噯	おくび
噯気	{噯氣}噯気。おくび
噯氣	{噯氣}噯気。おくび
曖	(アイ)〜(くら・い)
瞹	(アイ)
礙	{礙}碍。(ガイ)(ゲ)〜(さまた・げる)
安	(アン)〜(やす・い)(やす・まる)(やす)(やす・らか)(あ)(あす)(あず)(あっ)(や)『いずくに『いずくんぞ
庵	{庵}菴。(アン)〜(いおり)(いお)(あ)(い)(いほり)『いほ
鞍	(アン)〜(くら)
諳	(アン)(オン)〜(そら・んじる)『そらんずる
闇	(アン)(オン)〜(やみ)(くら・い)
鮟	(アン)
俺	(エン)〜(おれ)(われ)
唵	おん
岸	(ガン)〜(きし)(けし)
按	(アン)〜(おさ・える)(しら・べる)
案	(アン)〜(つくえ)
暗	(アン)〜(くら・い)『くれ『そらんずる『ひそかに
黯	(アン)〜(くら・い)
昂	(コウ)(ゴウ)〜(あ・がる)(たか・い)(たか・ぶる)(あき)(あきら)(たか)(たかし)(のぼる)『カウ
凹	(オウ)〜(くぼ・む)(へこ・む)(ぼこ)『アフ『くぼ
敖	(ゴウ)〜(あそ・ぶ)(おご・る)
遨	(ゴウ)〜(あそ・ぶ)
嗷	(ゴウ)〜(かまびす・しい)
熬	(ゴウ)〜(い・る)
螯	(ゴウ)〜(はさみ)
鏖	(オウ)〜(みなごろ・し)
鰲	(ゴウ)〜(おおがめ)
鼇	(ベツ)(ゴウ)〜(すっぽん)(おおがめ)
媼	(オオ)(オウ)〜(おうな)『うば
襖	(オウ)〜(ふすま)(あお)『アウ『アヲ
傲	(ゴウ)〜(おご・る)(あなど・る)『おごり『ガウ
奥	〔奧〕奥。(オウ)(オク)〜(おく・まる)(くま)(お)(おお)(おん)(つ)(のく)『アウ
奧	〔奧〕奥。(オウ)(オク)〜(おく・まる)(くま)『アウ
澳	(オウ)(イク)(オク)〜(おき)(くま)
懊	(オウ)〜(じれった・い)(なや・む)『アウ
八	(ハチ)〜(や)(や・つ)(やっ・つ)(よう)(な)(は)(はっ)(はつ)(やち)(やつ)(はちがしら)『パー
巴	(ハ)〜(ともえ)(うずまき)(とも)『ともゑ
叭	(ハツ)
朳	えんぶり
芭	(バ)(ハ)
捌	(ハツ)(ハチ)(ベツ)〜(さば・く)(さば・ける)(は・け)
笆	(ハ)『ませ
釟	(ハチ)(ハツ)
釛	(コク)〜(かね)
抜	〔拔〕抜。(バツ)(ハツ)(ハイ)〜(ぬ・く)(ぬ・く)(ぬ・き)(ぬ・ける)(ぬ・かす)(ぬ・かる)(ぬき)
拔	〔拔〕抜。(バツ)(ハイ)〜(ぬ・く)(ぬ・ける)(ぬ・かす)(ぬ・かる)
跋	(ハツ)(バツ)〜(おくがき)(ふ・む)
魃	(ハツ)(バツ)
把	(ハ)(ワ)〜(たば)『とる『ば『ぱ
罷	(ヒ)〜(まか・り)(や・める)『ハイ『まかる
覇	{霸}覇。(ハ)(ハク)〜(はたがしら)
霸	{霸}覇。(ハ)(ハク)〜(はたがしら)
欛	つか
白	(ハク)(ビャク)〜(しろ)(しら)(しろ・い)(あき)(か)(はっ)『もうす
白茅	ちがや
白糟	しらかす
百	(ヒャク)(ビャク)〜(もも)(お)(ど)(どう)(なり)(ひゃっ)(ひゅく)(も)(もんど)(ゆ)『ハク『ほ
百舌	もず
百舌鳥	もず
佰	(ヒャク)(ハク)〜(おさ)
柏	(ハク)(ヒャク)(ビャク)〜(かしわ)(かい)(かし)『かしは
栢	(ハク)(ヒャク)〜(かしわ)(かや)
瓸	(ヘクトグラム)
竡	(ヘクトリットル)
粨	(ヘクトメートル)
擺	(ハイ)〜(ひら・く)
拝	〔拜〕拝。(ハイ)〜(おが・む)(おろが・む)
拜	〔拜〕拝。(ハイ)〜(おが・む)(おろが・む)
敗	(ハイ)〜(やぶ・れる)
稗	(ハイ)(ヒ)〜(ひえ)
班	(ハン)
般	(ハン)
斑	(ハン)〜(ふ)(まだら)(い)『ぶち『むら
斑鳩	いかる
搬	(ハン)
頒	(ハン)〜(わか・つ)『わける
瘢	(ハン)〜(きず)
阪	(ハン)〜(さか)
坂	(ハン)〜(さか)(か)(ざ)『さか坂
板	(ハン)(バン)〜(いた)
版	(ハン)『バン『へん
鈑	(バン)(ハン)
半	(ハン)〜(なか・ば)(は)
伴	(ハン)(バン)〜(ともな・う)(とも)
拌	(ハン)
絆	(ハン)〜(きずな)(ほだ・す)(つな・ぐ)『づな『バン『ふもだし『ほだ『ほだし
瓣	(ベン)(ヘン)〜(わきま・える)(わ・ける)(はなびら)(あらそ・う)
扮	(フン)(ハン)(ヘン)〜(ふん・する)(やつ・す)(よそお・う)
邦	(ホウ)〜(くに)『ハウ
帮	{幫}帮。パン
浜	〔濱〕浜。(ヒン)〜(はま)
幇	{幫}幇。(ホウ)〜(たす・ける)『ハウ『パン
幫	{幫}帮。ハウ『パン『ホウ
榜	(ボウ)(ホウ)〜(かじ)(たてふだ)(ふだ)『バウ
蚌	(ボウ)(ホウ)(ビョウ)〜(はまぐり)(どぶが・い)
棒	(ボウ)
傍	(ボウ)〜(かたわ・ら)(わき)(おか)(はた)(そば)(び)『かたえ『そい『そひ『ハウ『バウ『へ『ホウ
傍ら	かたわら『はら
蒡	(ボウ)(ホウ)
磅	(ボウ)(ホウ)〜(ぽんど)
謗	(ボウ)(ホウ)〜(そし・る)『ハウ『バウ
勹	(ホウ)〜(つつ・む)(つつみがまえ)
包	{包}髱。(ホウ)〜(つつ・む)(くる・む)(お)(かね)『たぼ『つと『ハウ『パオ
苞	(ホウ)(ヒョウ)〜(つと)『ハウ
苞苴	つと
胞	(ホウ)『ハウ
褒	〔襃〕褒。(ホウ)〜(ほ・める)
襃	〔襃〕褒。(ホウ)〜(ほ・める)
雹	(ハク)(ヒョク)(ボク)〜(ひょう)
薄	(ハク)〜(うす・い)(うす)(うす)(うす・める)(うす・まる)(うす・らぐ)(うす・ら)(うす・れる)(すすき)
宀	(ベン)(メン)〜(うかんむり)
宝	〔寶〕宝。(ホウ)〜(たから)(ほ)
保	(ホ)(ホウ)〜(たも・つ)(う)(お)(ぶ)(もり)(やす)(やすし)『やすんずる
葆	(ホウ)(ホ)〜(し・げる)
堡	(ホ)(ホウ)〜(とりで)
飽	(ホウ)〜(あ・きる)(あ・かす)(あ・く)(あき)(あく)『ハウ
褓	(ホ)(ホウ)〜(むつき)
鴇	(ホウ)〜(とき)(のがん)『つき
寳	(ホウ)〜(たから)(み)
寶	〔寶〕宝。(ホウ)〜(たから)(たか)
抱	(ホウ)〜(だ・く)(いだ・く)(かか・える)(たば)『ハウ
豹	(ヒョウ)(ホウ)『ヘウ
報	(ホウ)〜(むく・いる)『しらせ『しらせる
鉋	{刨}鉋。(ホウ)(ビョウ)〜(かんな)
靤	(ホウ)〜(にきび)
髱	{包}髱。(ホウ)〜(たぼ)『つと
暴	(ボウ)(バク)〜(あば・く)(あば・れる)
鮑	(ホ)(ホウ)〜(あわび)『あはび
爆	(バク)〜(は・ぜる)『はじける
爆米	はぜ
陂	(ヒ)(ハ)〜(つつみ)
杯	{杯}盃。(ハイ)〜(さかずき)『つき『づき『はた
卑	〔卑〕卑。(ヒ)〜(いや・しい)(いや・しむ)(いや・しめる)
盃	{杯}盃。(ハイ)〜(さかずき)『づき
悲	(ヒ)〜(かな・しい)(かな・しむ)
碑	〔碑〕碑。(ヒ)〜(いしぶみ)『いしぶみ『えりいし『ゑり
鵯	(ヒ)(ヒツ)〜(ひよどり)『ひえどり
北	(ホク)〜(きた)(きら)(ほう)(ほっ)(ほつ)
孛	(ハイ)(ブツ)(ボツ)
貝	{貝}蛽。(バイ)〜(かい)『かひ
背	(ハイ)〜(せ)(せい)(そむ・く)(そむ・ける)『せな『そ『そびら
倍	(バイ)〜(べ)(ます)
狽	(ケン)(バイ)(ハイ)
悖	(ハイ)(ボツ)〜(もと・る)
被	(ヒ)〜(こうむ・る)(おお・う)(かぶ・る)(かぶ・せる)(ぎぬ)『かずき『かずく『かつぎ『かづき『きせ『ふすま
被り	かぶり
被衣	かずき『かつぎ『かづき
琲	(ハイ)〜(つらぬく)
備	(ビ)〜(そな・える)(そな・わる)(つぶさ・に)(びっ)(びん)
焙	(ホウ)(ハイ)〜(ほう・じる)(あぶ・る)『バイ『ハウ『ホイṬ
碚	(ハイ)
蛽	{貝}蛽。ばい
輩	(ハイ)〜(ばら)(やから)(やかい)(ともがら)
憊	(ハイ)(ヘイ)〜(つか・れる)
糒	(ビ)(ハイ)〜(ほしい)(ほしい・い)『いひ『ほしひ
鞴	(ヒ)(ビ)(フク)〜(ふいご)『がう『がは『ふいごう『ふきがわ
唄	(バイ)〜(うた)(うた・う)
奔	(ホン)『はしる
賁	(フン)(ヒ)(ホン)
犇	(ホン)〜(ひし・めく)(ひしひし)(は・しる)
本	(ホン)〜(もと)(まと)『ぼん『ぽん
夲	(ホン)〜(もと)
畚	(ホン)〜(もっこ)(ふご)
笨	(ホン)〜(あら・い)(がさ)
崩	(ホウ)〜(くず・れる)(くず・れ)(くず・す)
絣	(ホウ)〜(かすり)
繃	(ホウ)(ヒョウ)〜(まく)(たば・ねる)
迸	(ホウ)(ヒョウ)〜(ほとば・しる)(は・しる)
皀	(キュウ)(ヒョク)(キョウ)(コウ)
逼	(フク)(ヒツ)(ヒョク)(ヒキ)〜(せま・る)(むかばき)
柲	ふる
鼻	(ビ)〜(はな)
嬶	(かか)(かかあ)
匕	(ヒ)〜(さじ)(さじのひ)『かい『かひ
比	(ヒ)〜(くら・べる)(い)(ぴっ)『ころ『ごろ『たぐい
妣	(ヒ)〜(なきはは)
彼	(ヒ)〜(かれ)(かの)(か・の)(その)『あ『あの『あれ『か
彼方	おち『おと『をち『をと
秕	{秕}粃。(ヒ)〜(しいな)『しひな
俾	(フ)(ヒ)(ヘイ)〜(かしずく)(しむ)
粃	{秕}粃。(ヒ)〜(しな)(しいな)『しひな
筆	(ヒツ)〜(ふで)(くし)『ふみて『ふんで
鄙	(ヒ)〜(ひな)(ひな・びる)(いや・しい)
必	(ヒツ)〜(かなら・ず)
庇	(ヒ)〜(ひさし)(おお・う)(かば・う)
陛	(ヘイ)『きざはし
畢	(ヒツ)〜(おわ・る)(あみ)(おわ・り)(ことごとく)『おえる
閉	(ヘイ)〜(と・じる)(と・ざす)(し・める)(し・まる)(た・てる)(へ)
閇	(ヘイ)〜(と・じる)(と・ざす)(し・める)(し・まる)(た・てる)
敝	(ヘイ)〜(やぶ・れる)
婢	(ヒ)〜(はしため)
愎	(フク)(ヒョク)〜(もと・る)
弼	(ヒツ)〜(たす・ける)(ゆだめ)(すけ)(たすく)
蓖	(ヒ)(ヘイ)
痹	{痹}痺。しびれ『しびれる『ヒ
痺	{痹}痺。(ヒ)〜(しび・れる)『しびれ
裨	(ヒ)〜(おぎな・う)(たす・ける)(ます)
碧	(ヘキ)(ヒャク)〜(みどり)(あお)(たま)『あおい
鞁	(ヒ)
蔽	(ヘイ)(ヘツ)(フツ)〜(おお・う)(おお・い)
箆	(ヘイ)(ハイ)〜(へら)(の)(くし)
弊	(ヘイ)『ついえる
幣	(ヘイ)〜(ぬさ)(しで)『にきて『まい『まひ『みてぐら
幣帛	にきて『みてぐら
幤	(ヘイ)〜(ぬさ)
薜	(ヘイ)
篳	(ヒチ)(ヒツ)〜(まがき)
篦	(ヘイ)(ハイ)〜(へら)(の)
壁	(ヘキ)〜(かべ)
壁蝨	だに
避	(ヒ)〜(さ・ける)(よ・ける)
嬖	(ヘイ)〜(きにいり)
蹕	(ヒツ)〜(さきばらい)
髀	(ヒ)(ヘイ)〜(もも)
斃	(ヘイ)〜(たお・れる)(たお・す)
臂	(ヒ)〜(ひじ)『ただむき『ひぢ
璧	(ヘキ)〜(たま)
襞	(ヘキ)(ヒャク)〜(ひだ)(しわ)
躄	(ヘキ)〜(いざ・る)(いざ・り)『ゐ
贔	(ヒ)
鐴	へら
蝙	(ヘン)〜(こうもり)
編	(ヘン)〜(あ・む)(あ・み)『ふ『ぺん
邉	(ヘン)〜(あた・り)(ほと・り)(べ)(なべ)
鞭	(ベン)(ヘン)〜(むち)(むちうつ)『ぶち
邊	{邊}辺。(ヘン)〜(あた・り)(ほと・り)(べ)(なべ)『へ『へた
釆	(ハン)(ベン)〜(と)(いろどり)(うね)(のごめ)
扁	(ヘン)〜(ひらたい)
貶	(ヘン)〜(おとし・める)(おと・す)『けなす
褊	(ヘン)〜(せま・い)
卞	(ベン)(ヘン)(ハン)
弁	〔辨瓣辯〕弁。(ベン)(ヘン)〜(わきま・える)(わ・ける)(はなびら)(あらそ・う)(べ)
抃	(ベン)〜(う・つ)
汳	(ヘン)(ベン)
峅	(くら)
便	(ベン)(ビン)〜(たよ・り)『すなわち『よすが
変	{變}変。(ヘン)〜(か・わる)(か・わり)(か・える)
遍	(ヘン)〜(あまね・く)『あまねし『べん『ぺん
辨	(ベン)(ヘン)〜(わきま・える)(わ・ける)(はなびら)(あらそ・う)
辧	(ベン)(ヘン)〜(わきま・える)(わ・ける)(はなびら)(あらそ・う)
辮	(ベン)(ヘン)〜(あ・む)
辯	(ベン)(ヘン)〜(わきま・える)(わ・ける)(はなびら)(あらそ・う)
變	{變}変。(ヘン)〜(か・わる)(か・える)
髟	(ヒュウ)(ヒョウ)〜(かみがしら)(かみかんむり)
彪	(ヒョウ)(ヒュウ)〜(あや)(たけし)(たけ)(あきら)(かおる)(たけき)(つよし)(とら)『ヒウ『ヘウ
標	(ヒョウ)〜(しるべ)(しるし)(しべ)『しめ『しるす『ヘウ
膘	ほばら
驃	(ヒョウ)
飆	(ヒョウ)〜(つむじかぜ)
鑣	くつばみ『くつわ
驫	(ショウ)〜(とどろ)
表	(ヒョウ)〜(おもて)(おもて)(あらわ・す)(あらわ・れる)(あら・わす)『ヘウ
表裳	うは『うわも
俵	(ヒョウ)〜(たわら)『たはら『びょう『ぴょう『ヘウ『ベウ『ペウ
鰾	(ヒョウ)〜(ふえ)(うきぶくろ)『ほばら
鱉	{鱉}鼈。すっぽん『べつ
鼈	{鱉}鼈。(ベツ)(ヘツ)〜(すっぽん)
別	(ベツ)〜(わか・れる)(わ・ける)(べっ)『ベチ『わかつ『わけ
彬	(ヒン)(フン)〜(うるわ・しい)(あき・らか)(あきら)(あき)(よし)
斌	(ヒン)(フン)〜(うるわ・しい)(あき・らか)(たけ)
賓	〔賓〕賓。(ヒン・・)〜(・・・)『まらうど『まらひと『まれびと『まろうど
濱	〔濱〕浜。(ヒン)〜(はま)
檳	(ビン)(ヒン)
瀕	(ヒン)〜(ほとり)
繽	(ヒン)〜(おおし)
髩	たぼ『つと
擯	(ヒン)〜(しりぞ・ける)
殯	(ヒン)〜(かりもがり)『あらき『もがり
鬢	(ビン)(ヒン)
氷	{冰}氷。(ヒョウ)〜(こおり)(ひ)(こお・る)(すい)『こほり『つらら
氷柱	{冰柱}氷柱。つらら
冰	{冰}氷。(ヒョウ)〜(こおり)(ひ)(こお・る)『こほり『つらら
冰柱	{冰柱}氷柱。つらら
兵	(ヘイ)(ヒョウ)〜(つわもの)(へ)『いくさ『つは『ヒャウ『ヒヤウ
梹	(ヒン)
鋲	(びょう)『ビヤウ
丙	(ヘイ)〜(ひのえ)
秉	(ヘイ)〜(と・る)
柄	(ヘイ)〜(がら)(え)(つか)(から)(ら)『つく
柄杓	ひさく『ひしゃく
炳	(ヘイ)〜(あきらか)
禀	(リン)(ヒン)〜(こめぐら)
稟	(リン)(ヒン)〜(こめぐら)
鞆	(とも)『ほむた
餅	〔餠〕餅。(ヘイ)(ヒョウ)〜(もち)(もちい)『もちひ
餠	〔餠〕餅。(ヘイ)(ヒョウ)〜(もち)(もちい)
并	(ヘイ)(ヒョウ)〜(あわ・せる)(なら・ぶ)
併	{並}併。(ヘイ)〜(あわ・せる)『しかし『ならぶ『ならべる
並	{並}併。(ヘイ)(ホウ)〜(な・み)(なら・べる)(なら・ぶ)(なら・びに)(なび)『あわせる『しかし
垪	(ハ)
倂	{並}倂。あわせる『ヘイ
病	(ビョウ)(ヘイ)〜(や・む)(や・み)(やまい)『いたずき『いたつき『いたづき『ビャウ『やまひ
竝	〔竝〕並。(ヘイ)(ホウ)〜(な・み)(なら・べる)(なら・ぶ)(なら・びに)
癶	(ハツ)〜(はつがしら)
波	(ハ)〜(なみ)(ひら)(みな)(みなみ)(わ)
玻	(ハ)
剥	{剝}剥。(ハク)(ホク)〜(へ・ぐ)(へず・る)(む・く)(む・ける)(は・がれる)(は・ぐ)(は・げる)(は・がす)
剝	{剝}剥。はがす『はがれる『ハク『はぐ『はげる『むく『むける
菠	(ハ)(ホ)〜(ほうれんそう)
缽	{缽}鉢。ハチ『ハツ
鉢	{缽}鉢。(ハチ)(ハツ)
碆	(ハ)
播	(ハ)(バン)(ハン)〜(ま・く)(はり)
撥	(ハツ)(バチ)〜(は・ねる)(おさ・める)
伯	(ハク)〜(いき)(えき)(か)(き)(は)(ひろ)『かみ
帛	(ハク)〜(きぬ)
狛	(ハク)〜(こま)
泊	(ハク)〜(と・まる)(と・める)(とまり)(はつ)
勃	(ボツ)(ホツ)〜(おこ・る)(にわかに)
秡	(ハツ)(バチ)〜(はらい)
亳	(ハク)
舶	(ハク)
博	(ハク)(バク・)〜(ぐれ)(と)(はか)(ひろ・)『ひろい
渤	(ボツ)(ホツ)
搏	(ハク)〜(う・つ)(と・る)
鈸	はち
愽	(タン)
駁	{駁}駮。(ハク)(バク)〜(ぶち)(まじ・る)(まだら)
箔	(ハク)〜(すだれ)
膊	(ハク)〜(ほじし)
駮	{駁}駮。(カク)(ハク)〜(ぶち)(まだら)
鎛	さいずえ『さひづゑ
跛	(ハ)(ヒ)〜(びっこ)(ちんば)『あしなえ『なへ
檗	(ハク)(ビャク)〜(きはだ)(きわだ)
擘	(ハク)(ヒャク)(ヘキ)〜(さ・く)
簸	(ハ)〜(ひ・る)
蘗	(ハク)(ビャク)〜(きはだ)(きわだ)
卜	(ボク)〜(うらな・う)(うらない)(うら)(ぼくのと)
蔔	(フク)(ホク)
逋	(ホ)(フ)〜(のが・れる)
捕	(ホ)〜(と・らえる)(と・らわれる)(と・る)(とら・える)(とら・われる)(つか・まえる)(つか・まる)『ブ
哺	(ホ)〜(はぐく・む)(ふく・む)
補	(ホ)〜(おぎな・う)『フ
不	(フ)(ブ)『ず
布	(フ)〜(ぬの)(う)(の)(ほ)『しく『にの
步	{步}歩。あゆむ『あるく『かち『フ『ブ『ホ『ぽ
步行	{步行}歩行。かち
歩	{步}歩。(ホ)(ブ)(フ)〜(ある・く)(あゆ・む)(あ)(ゆき)(ゆみ)『かち『ぽ
歩行	{步行}歩行。かち
怖	(フ)(ホ)〜(こわ・い)(こわ・がる)(お・じる)(おそ・れる)『こは『こわ
捗	(チョク)(ホ)〜(はかど・る)『はか
部	(ブ)〜(べ)(とり)(ふ)(ぺ)(ま)
埠	(フ)(ホ)〜(つか)(はとば)
蔀	(ホウ)(ダ)(ダン)(ブ)〜(しとみ)
餔	(ホ)(フ)〜(く・う)(ゆうめし)
簿	(ボ)
擦	(サツ)〜(す・る)(す・れる)(ず・れ)(こす・る)(こす・れる)『かする
擦り	こすり
猜	(サイ)〜(ねた・む)『そねむ
才	{才}纔。(サイ)『かど『ザイ『ざえ『ひたた
材	(ザイ)〜(き)(さい)
財	(ザイ)(サイ)(ゾク)〜(たから)
裁	(サイ)〜(た・つ)(さば・く)
纔	{才}纔。(サン)(ザン)(サイ)〜(わずか)『ひたた
采	{采}採。(サイ)〜(と・る)(いろどり)
採	{采}採。(サイ)〜(と・る)
彩	(サイ)〜(いろど・る)(あや)(さ)(さえ)(つや)『だみ
綵	(サイ)〜(あや)(あやぎぬ)
菜	(サイ)〜(な)(よう)
菜蕗	ふき
蔡	(サイ)
参	{參}参。(サン)(シン)〜(まい・る)(まい)(まじわる)(みつ)(み)『まゐ『みっつ
參	{參}参。(サン)(シン)〜(まい・る)(まじわる)(みつ)『まい『まゐ『みっつ
喰	(く・う)(く・らう)(じき)
餐	(サン)(ソン)〜(の・む)(くら・う)
驂	(サン)〜(そえうま)
残	{殘}残。(ザン)(サン)〜(のこ・る)(のこ・す)(そこな・う)(のこ・り)
蚕	{蠶}蚕。(サン)(テン)〜(かいこ)(こ)『かひ
蚕簿	{蠶簿}蚕簿。まぶし
殘	{殘}残。(ザン)〜(のこ・る)(のこ・す)(そこな・う)(のこ・り)
慚	{慚}慙。(ザン)〜(はじ)(はじ・る)
慙	{慚}慙。(ザン)〜(はじ)(はじ・る)
蠶	{蠶}蚕。(サン)(テン)〜(かいこ)(こ)『かひ
蠶簿	{蠶簿}蚕簿。まぶし
惨	{慘}惨。(サン)(ザン)〜(みじ・め)(いた・む)(むご・い)
慘	{慘}惨。(サン)〜(みじ・め)(いた・む)(むご・い)『ザン
粲	(サン)〜(いい)
燦	(サン)〜(さん・たる)(あき・らか)(きらめ・く)(きら・めく)
倉	(ソウ)〜(くら)『サウ
蒼	(ソウ)〜(あお・い)『あお『サウ
滄	(ソウ)『サウ
艙	(ソウ)『サウ
蔵	{藏}蔵。(ゾウ)(ソウ)〜(くら)(おさ・める)(かく・れる)(くらし)(くらん)(くろう)(さし)(ざ)(ろう)『かくす『ザウ
藏	{藏}蔵。(ゾウ)(ソウ)〜(くら)(おさ・める)(かく・れる)『かくす『ザウ
操	(ソウ)(サン)〜(みさお)(あやつ・る)(さお)(みさ)『サウ『みさを
曹	(ソウ)(ゾウ)〜(つかさ)(ともがら)(へや)『サウ『ザウ
漕	(ソウ)〜(こ・ぐ)(はこ・ぶ)『サウ
槽	(ソウ)〜(ふね)『うけ『おけ『サウ
艚	(ソウ)
艸	(ソウ)〜(くさ)(くさかんむり)(そうこう)
草	(ソウ)〜(くさ)(くさ)(ぐさ)(そ)(や)『サウ
草叢	くさむら
草綿	わた
草片	くさびら
冊	(サツ)(サク)〜(ふみ)
册	(サツ)(サク)〜(ふみ)
厠	{廁}厠。(シ)(ショク)〜(かわや)『かう『かは『こうや
笧	しがらみ
側	(ソク)〜(かわ)(がわ)(そば)『かたわら『かは『がは『そばめる『はた『はら
策	(サク)『むち
廁	{廁}厠。(シ)(ショク)〜(かわや)『かう『かは『こうや
測	(ソク)〜(はか・る)
惻	(ソク)(ショク)〜(いた・む)
岑	(シン)(ギン)〜(みね)
噌	(ソウ)(ショウ)(ソ)〜(かまびす・しい)
曽	{曾}曽。(ソウ)(ソ)(ゾウ)〜(かつ)(かつて)(すなわち)『ゾ『ひ『ひい
曾	{曾}曽。(ソウ)(ソ)(ゾウ)〜(かつ・て)(か・って)(すなわち)『ゾ『ひ『ひい
層	〔層〕層。(ソウ)『こし
叉	(サ)(シャ)(サイ)〜(また)
扱	(ショウ)〜(あつか・る)(あつか・い)(あつか・う)『あつかう
扠	(サ)〜(さて)(さ・す)
挿	〔插〕挿。(ソウ)〜(さ・す)(はさ・む)『サフ
插	〔插〕挿。(ソウ)〜(さ・す)(はさ・む)『サフ
茶	(チャ)(サ)〜(ちや)
查	{查}査。サ『しらべる
査	{查}査。(サ)『しらべる
靫	(ジン)(ニン)(サ)(サイ)(サツ)〜(うつぼ)(うつお)(しな・やか)(ゆぎ)『うつほ『ゆき
槎	(サ)〜(いかだ)(き・る)
察	(サツ)
檫	さつ
岔	(タ)
侘	(タ)〜(わび・しい)(ほこ・る)(わ・びる)
刹	{剎}刹。(セチ)(セツ)(サツ)
差	(サ)〜(さ・す)(さ・し)『シ
詫	(タ)〜(わび)(わび・しい)(かこつ)(わ・びる)(わび・る)(たく)
拆	(タク)(セキ)〜(さく)(ひらく)
釵	(サイ)(サ)〜(かざし)(かんざし)
犲	(サイ)〜(やまいぬ)
柴	(サイ)(シ)〜(しば)『ふし
豺	(サイ)〜(やまいぬ)
儕	(セイ)(サイ)〜(ともがら)『ばら
覘	(テン)〜(のぞ・く)(うかが・う)
辿	(テン)〜(たど・る)(たどり)
禅	{禪}禅。(ゼン)(セン)〜(しずか)(ゆず・る)
孱	(セン)(サン)〜(よわ・い)
蝉	{蟬}蝉。(セン)(ゼン)〜(せみ)『せび
廛	(テン)〜(みせ)(やしき)(たな)
潺	(セン)(サン)
嬋	(セン)
禪	{禪}禅。(ゼン)(セン)〜(しずか)(ゆず・る)
襌	(タン)(ゼン)〜(ひとえ)
蟬	{蟬}蝉。せび『せみ『セン
蟾	(セン)
壥	(テン)
巉	(ザン)(サン)
纏	(テン)(デン)〜(まつ・わる)(まと・う)(まと・める)(まと・まる)(まと・い)『まとひ
躔	(テン)〜(ふ・む)
纒	(テン)〜(まつ・わる)(まと・う)(まと・める)(まと・まる)
讒	(ザン)(サン)〜(そし・る)
產	{產}産。うぶ『うまれる『うむ『サン『むす
産	{產}産。(サン)〜(う・む)(う・まれる)(うぶ)(む・す)(もと)
諂	(テン)〜(へつら・う)
闡	(セン)〜(みち・る)
懴	(ザン)(サン)〜(くい・る)
懺	(ザン)(サン)〜(くい・る)『セン
顫	(セン)〜(ふる・える)
昌	(ショウ)〜(さかん)(まさ)(まさし)(よし)(あき)(あきら)(さかえ)(あつ)(すけ)『あきらか『シャウ
菖	(ショウ)『シャウ
猖	(ショウ)〜(くる・う)
娼	(ショウ)〜(あそびめ)『シャウ『よね
椙	(すぎ)
鯧	がつを『まながつお
長	(チョウ)〜(なが・い)(おさ)(お)(おしゃ)(たかし)(たけ)(な)(は)(ひさ)『たき『たける『チャウ『チヤウ『つかさ『なが『をさ
長官	かう『こう
長雨	ながめ
萇	(チョウ)
常	(ジョウ)〜(つね)(とこ)(とき)(のぶ)(ひ)(ひた)『きだ『ジャウ『とこしえ『とことわ『とは『とわ
場	(ジョウ)(チョウ)〜(ば)『ヂャウ『ヂヤウ
甞	(ショウ)(ジョウ)〜(かつ・て)(な・める)
腸	(チョウ)〜(はらわた)『チャウ『チヤウ『わた
塲	(ジョウ)(チョウ)〜(ば)
嘗	(ショウ)(ジョウ)〜(かつ・て)(こころ・みる)(な・める)『シャウ『ジャウ
嫦	(コウ)(ジョウ)
膓	(チョウ)〜(はらわた)
蟐	(ジョウ)〜(もむ)
償	(ショウ)〜(つぐな・う)『シャウ
厂	(カン)〜(かりがね)(がんだれ)
昶	(チョウ)〜(あきら)
敞	(ショウ)〜(たか・い)(ほが・らか)(ひろ・い)(たかし)
厰	(ショウ)
廠	(ショウ)『シャウ
倡	(ショウ)〜(とな・える)(わざおぎ)
鬯	(チョウ)〜(かおりぐさ)
唱	(ショウ)〜(とな・える)『うたう『シャウ
悵	(チョウ)〜(いた・む)(うら・む)
暢	(チョウ)〜(のび・る)(いたる)(のぶ)(のぶる)(なが)(とうる)(とおる)(のり)(まさ)(みつる)(よう)『チャウ『のびやか
抄	(ショウ)〜(さ)(り)『すく『すくう『セウ
超	(チョウ)〜(こ・える)(こ・す)(まさる)(わたる)『テウ
鈔	(ショウ)『セウ
晁	(チョウ)〜(あさ)
巣	{巢}巣。(ソウ)〜(す)(す・くう)『サウ
巢	{巢}巣。サウ『す『ソウ
朝	(チョウ)〜(あさ)(あ)(あそ)(ささ)(ちか)(とも)『あした『テウ
樔	(ソウ)〜(す)(すく・う)(た・える)
嘲	(チョウ)(トウ)〜(あざけ・る)『テウ
潮	(チョウ)〜(しお)(うしお)(いた)『うしほ『しほ『テウ
炒	(ソウ)(ショウ)〜(い・る)(いた・める)
麨	はったい
車	(シャ)〜(くるま)(くら)(くろま)
偖	(シャ)〜(さて)
屮	(テツ)
掣	(セイ)(セツ)〜(ひ・く)
撤	(テツ)
徹	(テツ)〜(あき)(つ)(てっ)(とおる)『とおす
抻	(シン)(チン)
嗔	(シン)〜(いか・る)
瞋	(シン)〜(い・かる)(いか・らす)
臣	(シン)(ジン)〜(おみ)(たか)(と)(とみ)(み)『やつこ
辰	(シン)(ジン)〜(たつ)(とき)(のぶ)(のぶる)(しんのたつ)
辰巳	たつみ
忱	(シン)〜(まこと)
宸	(シン)〜(のき)
陳	(チン)〜(ひ・ねる)(のぶ)『つらねる『ならべる『のべる『ひね『ふるい
晨	(シン)〜(あした)(とき)(あさ)
塵	(チン)(ジン)〜(ちり)(ごみ)『ヂン
趁	(チン)〜(お・う)
齔	(シン)(ソン)(トン)〜(かけば)
襯	(シン)〜(はだぎ)
讖	(シン)
称	{稱}称。(ショウ)〜(たた・える)(とな・える)(あ・げる)(かな・う)(はか・り)(はか・る)(ほめ・る)(ね)
稱	{稱}称。(ショウ)〜(たた・える)(とな・える)(あ・げる)(かな・う)(はか・る)(ほめ・る)
瞠	(ドウ)(トウ)〜(みは・る)『ダウ
蟶	(テイ)〜(まて)
成	(セイ)(ジョウ)〜(な・る)(な・す)(な・す)(あき)(あきら)(しげ)(そん)(たえ)(なお)(なり)(なる)(のり)(ひら)(まさ)(よし)(り)『ジャウ
丞	(ジョウ)(ショウ)〜(すく・う)(たす・ける)(すけ)
呈	(テイ)
承	(ショウ)〜(うけたまわ・る)(う・ける)(つぐ)
城	(ジョウ)〜(しろ)(いく)(がき)(き)(くに)(ぐしく)(ぐすく)(しき)(すく)(ぜい)(たち)(なり)『さし『ジャウ『ジヤウ『セイ
乗	{乘}乗。(ジョウ)(ショウ)〜(の・る)(の・り)(の・せる)(のり)
乘	{乘}乗。(ジョウ)〜(の・る)(の・せる)
棖	ほこだち
程	(テイ)〜(ほど)(ほど)(ほと)
筬	(セイ)〜(おさ)『をさ
誠	(セイ)〜(まこと)(きよ)(さと)(しげ)(とも)(のぶ)(ま)(まこ)(まさ)
酲	(テイ)
澂	(チョウ)〜(すま・す)(す・む)
澄	(チョウ)〜(す・む)(す・ます)(す・ます)(きよ)(すす)(すみ)(み)
橙	(トウ)〜(だいだい)
懲	〔懲〕懲。(チョウ)〜(こ・りる)(こ・らす)(こ・らしめる)
逞	(テイ)〜(たくま・しい)
騁	(テイ)〜(はせ・る)
秤	(ショウ)(ヒン)(ビン)〜(はかり)
吃	{吃}喫。(キツ)〜(ども・る)『チー
妛	(シ)〜(あなど・る)(おろか)(みにく・い)(みだる)
蚩	(シ)
笞	(チ)〜(むち)(しもと)
喫	{吃}喫。(キツ)
嗤	(シ)〜(わら・う)
痴	{癡}痴。(チ)〜(し・れる)(おろか)『おこ『をこ
螭	づ『みずち
鴟	{鴟}鵄。(シ)〜(とび)
鵄	{鴟}鵄。(シ)〜(とび)
魑	(チ)〜(すだま)
魑魅	すだま
癡	{癡}痴。(チ)〜(し・れる)(おろか)『おこ『をこ
黐	(チ)(リ)〜(もち)『とりもち
池	(チ)〜(いけ)
弛	(チ)(シ)〜(たる・む)(たる・める)(たゆ・む)(ゆる・む)(ゆる・み)『ゆるめる
岻	(ジ)(ニ)〜(し)
持	(ジ)〜(も・つ)(も・ち)(も・てる)(もち)(もつ)『チ『ヂ
遅	{遲}遅。(チ)〜(おく・れる)(おく・らす)(おそ・い)(じ)『おそ
馳	(チ)(ジ)〜(は・せる)
踟	(チ)
遲	{遲}遅。(チ)〜(おく・れる)(おく・らす)(おそ・い)『おそ
尺	(シャク)〜(せき)『さか『さし
叺	(かます)
呎	(シャク)〜(ふいいと)『フィート
侈	(シ)〜(おご・る)
耻	(チ)〜(は・じる)(はじ)(は・じらう)(は・ずかしい)
恥	(チ)〜(は・じる)(はじ)(は・じらう)(は・ずかしい)『はぢ
歯	{齒}歯。(シ)〜(よわい)(は)(よわ・い)(よわい・する)『よはひ
歯肉	{齒肉}歯肉。はじし
齒	{齒}歯。(シ)〜(よわい)(は)(よわ・い)(よわい・する)『よはひ
齒肉	{齒肉}歯肉。はじし
褫	(チ)〜(うば・う)
彳	(テキ)〜(たた・ずむ)(ぎょうにんべん)
𠮟	しかる『シツ
叱	(シツ)(シチ)〜(しか・る)『しっ
斥	(セキ)〜(しりぞ・ける)
赤	(セキ)(シャク)〜(あか)(あか)(あか・い)(あか・らむ)(あか・らめる)(あ)(あこ)(あま)
勅	{敕}勅。(チョク)〜(いまし・める)(みことのり)(て)(のり)
翅	(シ)〜(はね)(つばさ)
敕	{敕}勅。(チョク)〜(いまし・める)(みことのり)
飭	(チョク)(チキ)〜(いまし・める)(ただ・す)
啻	(シ)〜(ただ・ならぬ)(ただ・に)
腟	(チツ)
熾	(シ)〜(おこ・る)(おこ・す)(さかん)『おき
冲	(チュウ)〜(おき)(おきつ)(ちゅう・する)(わく)
充	(ジュウ)〜(あ・てる)(み・たす)(あつ)(のぶ)(まさ)(みち)(みつ)(よし)『みちる
沖	(チュウ)〜(おき)(おきつ)(ちゅう・する)(わく)
舂	(ショウ)〜(うすつ・く)(うすづ・く)(つ・く)
衝	(ショウ)〜(つ・く)
憧	(ショウ)(トウ)(ドウ)〜(あこが・れる)
艟	(ドウ)(ショウ)(トウ)〜(いくさぶね)
虫	〔蟲〕虫。(チュウ)(キ)〜(むし)(む)
虫の垂れ絹	むしのたれぎぬ
崇	(スウ)〜(あが・める)(す)(たか)(たかし)(たかむ)
蟲	〔蟲〕虫。(チュウ)(キ)〜(むし)
寵	(チョウ)〜(めぐ・み)(めぐ・む)
銃	(ジュウ)『つつ
抽	(チュウ)〜(ひき)『チウ『ぬきんでる『ぬく
紬	(チュウ)〜(つむぎ)(つむ・ぐ)『チウ
仇	(キュウ)(グ)〜(あだ)(あた)(かたき)(つれあい)『あだする『キウ
惆	(チュウ)〜(うら・む)
畴	(チュウ)〜(うね)(たぐい)(ひと・しい)
酬	(シュウ)(シュ)(トウ)〜(むく・いる)『シウ『むくい
稠	(チュウ)(チョウ)〜(おお・い)(し・げる)『チウ
愁	(シュウ)〜(うれ・える)(うれ・い)『シウ
綢	(チュウ)(トウ)〜(まとう)
儔	(チュウ)(ジュ)〜(ともがら)
疇	(チュウ)〜(うね)(たぐい)(ひと・しい)『チウ
籌	(チュウ)〜(かずとり)(はかりごと)『チウ
躊	(チュウ)(チュ)(シュウ)(ジュ)〜(ためら・う)
讐	(シュウ)〜(あだ)(むく・いる)(あ・たる)『シウ
讎	(シュウ)〜(あだ)(むく・いる)
丑	(チュウ)〜(うし)(ひろ)『チウ
丑寅	うしとら
醜	(シュウ)〜(みにく・い)(しこ)『シウ
臭	〔臭〕臭。(シュウ)〜(くさ・い)(くさ・い)(にお・う)(にお・い)『シウ
臭橙	だいだい
臭気	{臭氣}臭気。かざ
臭氣	{臭氣}臭気。かざ
出	(シュツ)(スイ)〜(で・る)(で)(だ・す)(だ・す)(い・でる)(い・だす)(いず)(いづ)(いで)(じ)(すっ)(すつ)(てん)『ず『づ
初	(ショ)〜(はじ・め)(はじ・めて)(はつ)(はつ)(うい)(そ・める)(ぞ・め)(し)(はっ)『うひ『うぶ
初心	うぶ
樗	(チョ)〜(おおち)(おうち)(ちょう)『あふち
齣	(シャク)(シュツ)(セキ)〜(こま)『せつ
除	(ジョ)(ジ)〜(のぞ・く)(よ・け)『ヂ『ヂョ『ヂヨ
芻	(スウ)(シュウ)(ス)〜(まぐさ)
厨	{廚}厨。(シュウ)(ズ)(チュ)(チュウ)〜(くりや)『ヅ
耡	(ジョ)〜(す・く)(すき)
蒭	(シュウ)(ス)(スウ)〜(まぐさ)
蜍	(ショ)
鋤	{鋤}鉏。(ジョ)(ショ)(ソ)〜(す・く)(すき)(くわ)『さい『さひ
廚	{廚}厨。(シュウ)(ズ)(チュ)(チュウ)〜(くりや)『ヅ
躇	(チョ)(チャク)〜(ためら・う)
雛	(スウ)(ス)(ジュ)〜(ひな)(ひよこ)『ひいな『ひひな『ひよっこ
杵	(ショ)(ソ)〜(きね)(き)
楮	(チョ)〜(こうぞ)『かうぞ『かじ『かぞ『かぢ
楚	(ソ)(ショ)〜(いばら)(しもと)(すわえ)『すはえ『すばえ
儲	(チョ)〜(もう・ける)(もう・かる)(もうけ)(たくわ・える)
礎	(ソ)〜(いしずえ)(もと)『ずゑ
処	{處}処。(ショ)〜(ところ)(こ)(お・る)『おく『か『く『と『どころ
俶	(シュク)(テキ)〜(はじめ)(よい)
畜	(チク)
處	{處}処。(ショ)〜(ところ)(こ)(お・る)『おく『か『く『と『どころ
触	{觸}触。(ショク)〜(ふ・れる)(さわ・る)(さわ)『そく
黜	(チュツ)〜(しりぞ・ける)
觸	{觸}触。(ショク)〜(ふ・れる)(さわ・る)『そく
矗	(チョク)(シュク)(チク)〜(なお・い)
揣	(シ)(スイ)(タン)〜(はか・る)
川	(セン)〜(かわ)(か)(こ)(さわ)(さんぼんがわ)『かは
川獺	かは『かわうそ
川原	かはら『かわら
巛	(セン)〜(かわ)(まがりがわ)
穿	(セン)〜(うが・つ)(は・く)
舩	(セン)〜(ふね)(ふな)
船	(セン)〜(ふね)(ふな)(ふ)
船筎	のみ
船首	みよし
船縁	{船緣}船縁。ふなべり
船緣	{船緣}船縁。ふなべり
椽	(テン)〜(えん)(たるき)
傳	〔傳〕伝。(テン)(デン)〜(つた・わる)(つた・える)(つた・う)(つて)
舛	(ブ)(セン)〜(まい)(そむ・く)(ます)(まいあし)
喘	(ゼン)(セン)〜(あえ・ぐ)(せき)
串	(カン)(ケン)(セン)〜(くし)(つらぬ・く)『くし
釧	(セン)〜(くしろ)(うでわ)(くし)
窓	{窗}窓。(ソウ)(ス)〜(まど)(てんまど)(けむだし)『サウ
窗	{窗}窓。(ソウ)(ス)〜(まど)(てんまど)(けむだし)『サウ
瘡	(ソウ)(ショウ)〜(かさ)『くさ『サウ
床	(ショウ)〜(とこ)(ゆか)『シャウ『シヤウ
牀	(ショウ)(ソウ)〜(ゆか)『シャウ『シヤウ
闖	(チン)〜(うかが・う)
剏	(ソウ)(ショウ)〜(はじ・める)
創	(ソウ)(ショウ)〜(つく・る)(はじ・める)(きず)(けず・しける)(はじめ)『サウ
愴	(ソウ)〜(いたま・しい)(いた・む)『サウ
吹	(スイ)〜(ふ・く)(ふき)
吹き皮	がは『ふきがわ
炊	(スイ)〜(た・く)(だ・き)(い)『かしぐ
垂	(スイ)〜(た・れる)(た・らす)(た・れ)(た・れ)(なんなんと・す)(たる)(だれ)『しずる『しだれる『なんなんとする
埀	(スイ)〜(た・れる)(た・らす)(なんなんと・す)
陲	(スイ)〜(ほとり)
捶	(スイ)〜(むちう・つ)
槌	(ツイ)〜(つち)
錘	{錘}鎚。(スイ)〜(つむ)(おもり)『ツイ『つち
鎚	{錘}鎚。(ツイ)(タイ)〜(つち)
春	(シュン)〜(はる)(あずま)(かす)(すの)(ひ)(わら)
椿	(チン)(チュン)〜(つばき)(つば)
鰆	(シュン)〜(さわら)『さはら
唇	{唇}脣。(シン)〜(くちびる)
純	(ジュン)〜(あつ)(すみ)(み)(やすし)(よし)
脣	{唇}脣。(シン)〜(くちびる)
淳	(ジュン)(シュン)〜(あつ・い)(あつ)(あつし)(きよ)(きよし)(まこと)(すなお)
醇	(ジュン)(シュン)〜(もっぱら)(こい)(あつい)
鶉	(ジュン)(シュン)〜(うずら)『うづら
惷	(シュン)
蠢	(シュン)〜(うご・めく)
戳	(タク)
啜	(セツ)(テツ)〜(すす・る)
綽	(シャク)〜(あだ)(しな・やか)(ゆる・やか)
輟	(テツ)〜(や・める)
齪	(サク)(ソク)(セク)(シュク)(シュウ)〜(せま・る)
疵	(シ)〜(きず)
縒	(シ)(サ)〜(よ・る)
茨	(シ)(ジ)〜(いばら)(かや)(くさぶき)(あし)(えばら)(ばら)(まつ)(まん)『うばら『むばら
祠	(シ)〜(ほこら)(まつる)
瓷	(シ)〜(かめ)
詞	(シ)『ことば
辞	{辭}辞。(ジ)〜(や・める)(いな・む)『ことば
慈	(ジ)〜(いつく・しむ)(しげ)(ちか)(めぐみ)(よし)
磁	(ジ)
雌	(シ)〜(め)(めす)(めん)
辭	{辭}辞。(ジ)〜(や・める)『ことば
此	(シ)〜(こ・れ)(こ・の)(ここ)『こ『こん
此れ	これ
此処	{此處}此処。ここ
此處	{此處}此処。ここ
此所	ここ
朿	(シ)〜(とげ)
次	(ジ)(シ)〜(つ・ぐ)(つぎ)(き)(すき)(つぐ)(よし)
刺	(シ)〜(さ・す)(さ・さる)(さ・し)(さし)(とげ)『いら『セキ
賜	(シ)〜(たまわ・る)(たま・う)(たも・う)『たまもの
匆	{匆}怱。(ソウ)〜(いそが・しい)
怱	{匆}怱。(ソウ)〜(にわか)(あわ・てる)(さと)
葱	(ソウ)〜(ねぎ)『き
楤	たら
聡	〔聰〕聡。(ソウ)〜(さと・い)(みみざと・い)(さと)(さとし)(さとる)(あき)(あきら)(とし)(さた)(みのる)
樅	(ショウ)〜(もみ)
聰	〔聰〕聡。(ソウ)〜(さと・い)(みみざと・い)(あきら)(さとし)
从	(ショウ)(ジュウ)(ジュ)〜(したが・う)(したが・える)(より)
従	{從}従。(ジュウ)(ショウ)(ジュ)〜(したが・う)(したが・える)(より)『ひろい
從	{從}従。(ジュウ)(ショウ)(ジュ)〜(したが・う)(したが・える)(より)『ひろい
淙	(ソウ)
叢	(ソウ)(ス)〜(くさむら)(むら・がる)(むら)
叢祠	ほこら
湊	(ソウ)〜(みなと)(あつ・まる)
輳	(ソウ)〜(あつ・まる)
粗	{麤}粗。(ソ)〜(あら・い)(あら)『ほぼ
麁	{麤}麁。(ソ)〜(あら・い)
麤	{麤}粗。あら『あらい『ソ『ほぼ
徂	(ソ)〜(ゆ・く)
促	(ソク)〜(うなが・す)
猝	(ソツ)〜(にわか)
蔟	(ゾク)(ソウ)〜(まぶし)
醋	(サク)〜(す)
簇	(ゾク)(ソウ)(ソク)〜(むら・がる)『むら
蹙	(シュク)(セキ)〜(せ・まる)
蹴	(シュク)(シュウ)〜(け・る)『シウ
攅	(サン)〜(あつ・まる)
篡	{篡}簒。うばう『サン
簒	{篡}簒。(サン)(セン)〜(うば・う)
竄	(ザン)(サン)〜(かく・れる)(のが・れる)
爨	(サン)〜(かし・ぐ)(かまど)
崔	(ガイ)(サイ)(スイ)〜(がけ)
催	(サイ)〜(もよう・す)(もよお・す)
摧	(サイ)(サ)〜(くだ・く)『くだける
榱	(スイ)〜(たるき)
伜	(サイ)(ソツ)(ソチ)〜(せがれ)
忰	(スイ)〜(せがれ)(やつ・れる)
脆	(ゼイ)(セイ)(セツ)〜(もろ・い)(よわい)
翆	(スイ)〜(かわせみ)(みどり)
萃	(スイ)(サイ)〜(あつ・まる)
淬	(サイ)〜(にらぐ)
悴	(スイ)〜(せがれ)(やつ・れる)『かせ
毳	(ゼイ)(セイ)(セツ)〜(けば)(むくげ)
瘁	(スイ)〜(つか・れる)
粹	{粹}粋。(スイ)〜(いき)
翠	(スイ)〜(かわせみ)(みどり)(あきら)
膵	(スイ)『スイẎ
邨	(ソン)〜(むら)
村	(ソン)〜(むら)(え)(むた)(ら)
皴	(シュン)〜(ひび)(しわ)
存	(ソン)(ゾン)〜(まさ)
拵	(ソン)〜(こしら・える)
忖	(ソン)〜(はか・る)
寸	(スン)〜(す)(みき)『き
寸莎	すさ『つた
吋	(トウ)(ドウ)(スン)〜(いんち)
搓	(サ)(サイ)〜(よ・る)
瑳	(サ)〜(みが・く)
磋	(サ)〜(みが・く)
撮	(サツ)〜(と・る)(つま・む)(ど・り)
蹉	(サ)〜(つまず・く)
嵯	(サ)(シ)
嵯峨	さが
嵳	(サ)
痤	にきみ
挫	(ザ)(サ)〜(くじ・く)(くじ・ける)
措	(ソ)〜(お・く)
錯	(サク)(シャク)『こすり
搭	(トウ)『タフ
迚	(とても)(とて)
怛	(ダツ)(タン)(タツ)〜(いた・む)
妲	(ダツ)
逹	(タツ)(ダ)〜(たち)(て)
剳	(トウ)(サツ)(チョウ)〜(さ・す)
達	(タツ)(ダ)〜(たち)(かつ)(さと)(て)(てつ)(とおる)(みち)『ダチ
答	(トウ)〜(こた・える)(こた・え)(どう)『いらえる『タフ
靼	(タン)(タチ)(タツ)〜(なめ・す)(なめしがわ)
燵	(タツ)
韃	(ダツ)(タツ)〜(だっ)
打	(ダ)(ダアス)〜(う・つ)(う・ち)(ぶ・つ)(うち)『チャウ『チョウ
大	(ダイ)(タイ)〜(おお)(おお・きい)(おお・いに)(うふ)(お)(おう)(た)(たかし)(とも)(はじめ)(ひろ)(ひろし)(まさ)(まさる)(もと)(わ)『おほ
大凡	おおよそ『おほ
大夫	まえつきみ『まへ
大口魚	たら
大領	おおくび『おほ
大粟	おおあわ『おほあは
大蒜	にんにく
大雁	おおがり『おほ
大御	おおむ『おおん『おほ
呆	(ホウ)〜(ほけ・る)(ぼ・ける)(あき・れる)(おろか)『ハウ『バウ『ボウ
歹	(ガツ)(ガチ)(タイ)〜(がつへん)(いちたへん)(しにがまえ)
逮	(タイ)
代	(ダイ)(タイ)〜(か・わる)(かわ・る)(かわ・り)(がわ・り)(か・える)(よ)(しろ)(す)
垈	(ハツ)(ボチ)〜(ぬた)
岱	(タイ)
玳	(タイ)〜(たいまい)
殆	(タイ)(サイ)〜(ほとほと)(ほとん・ど)(あやうい)
待	(タイ)〜(ま・つ)(ま・ち)(まち)(まつ)
怠	(タイ)〜(おこた・る)(なま・ける)『ダイ『だるい
帯	{帶}帯。(タイ)〜(お・びる)(おび)(たて)
帶	{帶}帯。(タイ)〜(お・びる)(おび)
袋	(タイ)(ダイ)〜(ふくろ)(てい)(ない)(ぶく)
紿	(タイ)〜(あざむ・く)
貸	(タイ)〜(か・す)(か・し)(かし)
戴	(タイ)〜(いただ・く)
黛	(タイ)〜(まゆずみ)
靆	(タイ)
卩	(セツ)〜(わりふ)(ふしづくり)
丹	(タン)〜(に)(た)(たみ)(まこと)『あかい
担	{擔}担。(タン)〜(かつ・ぐ)(にな・う)
眈	(タン)〜(にら・む)
単	{單}単。(タン)〜(ひとえ)
耽	(タン)〜(ふ・ける)
酖	(タン)(チン)〜(ふ・ける)
單	{單}単。(タン)〜(ひとえ)
鄲	(タン)
箪	{簞}箪。(タン)〜(はこ)
褝	(タン)(ゼン)〜(ひとえ)
殫	(タン)〜(つき・る)
簞	{簞}箪。タン
胆	{膽}胆。(タン)〜(きも)(い)(まこと)
疸	(タン)
亶	(タン)(セン)〜(あつ・い)(ほしいまま)
擔	{擔}担。(タン)〜(かつ・ぐ)(にな・う)
膽	{膽}胆。(タン)〜(きも)『い
旦	(タン)(ダン)〜(あき・らか)(あきら)(ただし)(あさ)(あした)
但	(タン)〜(ただ・し)(たじ)『ただ『ただし
啗	(タン)〜(く・らわす)(く・う)(く・らう)
啖	(タン)〜(く・う)(くらわ・す)
淡	(タン)〜(あわ・い)
蛋	(タン)
蜑	(タン)〜(あま)
誕	(タン)
憚	(タン)(タ)〜(はばか・る)
彈	〔彈〕弾。(ダン)(タン)〜(ひ・く)(はず・む)(たま)(はじ・く)(はじ・ける)(ただ・す)
餤	(タン)
澹	(タン)(セン)〜(あわ・い)
憺	(タン)
当	{當}当。(トウ)〜(あ・たる)(あ・たり)(あ・てる)(あ・て)(まさ・に)(まさ・にべし)(たい)『タウ『はた『まさに…べし
当て	あて
當	{當}当。(トウ)〜(あ・たる)(あ・てる)(まさ・に)(と)『タウ『はた『まさに…べし
當て	あて
璫	こじり
襠	(トウ)〜(ふんどし)(まち)
蟷	(トウ)
鐺	(ト)(ソウ)(トウ)〜(くさり)(こじり)(こて)(なべ)
档	(トウ)
党	{黨}党。(トウ)〜(なかま)(むら)『タウ『たむら
黨	{黨}党。(トウ)〜(なかま)(むら)『タウ『たむら
宕	(トウ)〜(すぎる)
蕩	(トウ)〜(とろ・かす)(とろ・ける)(うご・く)『タウ
盪	(トウ)〜(とろ・かす)(あら・う)(うご・く)
礑	(トウ)〜(はた)(はたと)
蘯	(トウ)〜(とろ・かす)(あら・う)(うご・く)
刀	(トウ)〜(かたな)(そり)(き)(ち)(と)(わき)『タウ
叨	(トウ)〜(みだりに)
朷	(トウ)
釖	(トウ)〜(かたな)(そり)
陦	(トウ)(チョウ)〜(しま)
倒	(トウ)〜(たお・れる)(だお・れ)(たお・す)『さか『さかしま『タウ
島	{島}嶋。(トウ)〜(しま)『タウ
祷	{禱}祷。(トウ)〜(いの・る)(いの・り)(まつ・る)『タウ
搗	(トウ)〜(つ・く)(か・つ)
槝	(かし)
嶋	{島}嶋。(トウ)〜(しま)
嶌	(トウ)〜(しま)
導	(ドウ)〜(みちび・く)(みち)『しるべ『ダウ
擣	(トウ)〜(う・つ)(つ・く)
蹈	(トウ)〜(ふ・む)
禱	{禱}祷。いのる『タウ『トウ
到	(トウ)〜(いた・る)『タウ
盗	〔盜〕盗。(トウ)〜(ぬす・む)(ぬす・み)『タウ
悼	(トウ)〜(いた・む)『タウ
椡	(トウ)
道	(ドウ)(トウ)〜(みち)(さ)(じ)(ど)(みつ)『タウ『ダウ『ち『ぢ
盜	〔盜〕盗。(トウ)〜(ぬす・む)『タウ
稲	{稻}稲。(トウ)(テ)〜(いね)(いな)(いの)(しね)(せ)(な)『タウ
稲孫	{稻孫}稲孫。ひつじ『ひつぢ
稻	{稻}稲。(トウ)(テ)〜(いね)(いな)『しね『タウ
稻孫	{稻孫}稲孫。ひつじ『ひつぢ
纛	(トウ)(トク)〜(はたぼこ)『タウ
得	(トク)〜(え・る)(う・る)(あつ)(てろ)『う『え
悳	(トク)〜(いさお)
徳	{德}徳。(トク)〜(あつ)(なる)(のり)(ゆき)(よし)
德	{德}徳。トク
的	(テキ)〜(まと)(いくは)(ゆくは)
灯	{燈}灯。(トウ)〜(ひ)(ほ)(ともしび)(とも・す)(あかり)『あかし『チンṬ『とぼし『ともし
登	(トウ)(ト)(ドウ)(ショウ)(チョウ)〜(のぼ・る)(あ・がる)(たか)(のぼし)(のぼり)(のり)
燈	{燈}灯。(トウ)〜(ひ)(ほ)(ともしび)(とも・す)(あかり)『あかし『チンṬ『とぼし『ともし
等	(トウ)〜(ひと・しい)(など)(ら)(と)(ひ)
嶝	(トウ)〜(さかみち)
磴	(トウ)
鐙	(トウ)〜(あぶみ)(たかつき)(ひともし)
低	(テイ)〜(ひく・い)(ひく・める)(ひく・まる)
羝	(ラン)(テイ)〜(おひつじ)
堤	(テイ)〜(つつみ)
滴	(テキ)〜(しずく)(したた・る)『しづく
廸	(テキ)〜(みち)(みち・びく)(すす・む)(いた・る)
狄	(テキ)〜(えびす)
迪	(テキ)〜(みち)(みち・びく)(すす・む)(いた・る)(すすむ)(すすみ)(いたる)(ゆう)
荻	(テキ)〜(おぎ)『をぎ
笛	(テキ)〜(ふえ)(う)『ちゃく
髢	(テイ)(セキ)〜(かもじ)
滌	(デキ)(テキ)(ジョウ)〜(あら・う)
嫡	(チャク)(テキ)
敵	(テキ)〜(かたき)(かな・う)
鏑	(テキ)〜(かぶら)(かぶらや)(やじり)
糴	(チョウ)(テキ)〜(う・る)(せり)(かいよね)『かひ
氐	てい
邸	(テイ)〜(やしき)(むら)
抵	{抵}牴。(テイ)
底	(テイ)〜(そこ)
柢	(テイ)〜(ね)
牴	{抵}牴。(テイ)〜(ふ・れる)
砥	(シ)(テイ)(キイ)(チ)〜(と)(といし)(と・ぐ)(みが・く)(たいら・にする)
觝	(テイ)〜(ふ・れる)
詆	(テイ)(タイ)〜(そし・る)(しか・る)
楴	(テイ)
地	(チ)(ジ)〜(どま)『ヂ『つち
弟	(テイ)(ダイ)(デ)〜(おとうと)(て)『おと『おとと『おとひと
俤	(おもかげ)(てい)
帝	(テイ)〜(みかど)『タイ
逓	〔遞〕逓。(テイ)〜(かわ・る)(たがいに)
第	(ダイ)(テイ)
蒂	{蒂}蔕。(テイ)(タイ)〜(へた)『ほぞ
棣	(テイ)(タイ)〜(にわざくら)
睇	(テイ)(ダイ)
遞	〔遞〕逓。(テイ)〜(かわ・る)(たがいに)
蔕	{蒂}蔕。(テイ)(タイ)〜(へた)『ほぞ
締	(テイ)〜(し・まる)(し・まり)(し・める)(し・め)(じ・め)
諦	(テイ)(タイ)〜(あき・らめる)(あきら・める)(つまびらか)(まこと)
滇	てん
槙	〔槇〕槙。(テン)(シン)〜(まき)(こずえ)
顛	(テン)〜(いただき)(たお・れる)
巔	{巔}巓。テン
巓	{巔}巓。(テン)〜(いただき)
癲	(テン)
丶	(チュ)〜(てん)
典	(テン)(デン)〜(すけ)(つね)(の)(のり)『さかん
点	{點}点。(テン)〜(つ・ける)(つ・く)(た・てる)(さ・す)(とぼ・す)(とも・す)(ぼち)『ちょぼ
点火	{點火}点火。とぼし
椣	(しで)
點	{點}点。(テン)〜(つ・ける)(つ・く)(た・てる)(さ・す)(とぼ・す)(とも・す)(ぼち)『ちょぼ
點火	{點火}点火。とぼし
佃	(テン)(デン)〜(つくだ)『つくりだ
甸	(デン)(テン)〜(かり)
店	(テン)〜(みせ)(たな)
淀	{淀}澱。(テン)(デン)〜(よど・む)『おり『よど
奠	(テン)(デン)(テイ)〜(さだ・める)(まつ・る)
電	(デン)『いなずま『テン
鈿	(デン)(テン)〜(かんざし)
殿	(デン)(テン)〜(との)(どの)(て)(どん)『あらか『しんがり
澱	{淀}澱。(デン)(テン)〜(おり)(ど・ろ)(よど・み)(よど・む)『よど
簟	(タン)(テン)〜(たかむしろ)
癜	(デン)(テン)〜(なまず)『なまづ
凋	(チョウ)〜(しぼ・む)『テウ
彫	{雕}彫。(チョウ)〜(ほ・る)(ぼ・り)『テウ
貂	(チョウ)〜(てん)
鳭	つき
雕	{雕}彫。(チョウ)〜(きざ・む)(わし)(ほ・る)『テウ
簓	(ささら)
鯛	(チョウ)〜(たい)『たひ
弔	{吊}弔。(チョウ)〜(とむら・う)(とぶら・う)『テウ
吊	{吊}弔。(チョウ)〜(つ・る)(つる・す)『テウ『とむらう
掉	(トウ)(チョウ)〜(ふる・う)
釣	(チョウ)〜(つ・る)(つ・り)(つ・り)(つり)『テウ
調	(チョウ)〜(しら・べる)(しら・べ)(ととの・う)(ととの・える)(ぎ)(つぎ)『つき『テウ『みつぎ
跌	(テツ)〜(あやまつ)(つまず・く)
迭	(テツ)
垤	(テツ)〜(ありづか)
耋	(テツ)〜(としより)
喋	(チョウ)(トウ)〜(しゃべ・る)(ついば・む)
畳	{疊}畳。(ジョウ)(チョウ)〜(たた・む)(たたみ)(かさ・なる)『デフ
牒	(チョウ)(ジョウ)〜(ふだ)『テフ
蝶	(チョウ)『テフ
疂	(ジョウ)(チョウ)〜(たた・む)(たたみ)(かさ・なる)(かさ・ねる)
諜	(チョウ)〜(ちょう・ずる)(うかが・う)(しめ・す)『テフ
疉	(ジョウ)(チョウ)〜(たた・む)(たたみ)(かさ・なる)
鰈	(チョウ)(トウ)〜(かれい)『かれひ
疊	{疊}畳。(ジョウ)(チョウ)〜(たた・む)(たたみ)(かさ・なる)(かさ・ねる)『デフ
丁	(チョウ)(テイ)(チン)(トウ)(チ)〜(ひのと)『チャウ『チヤウ『よほろ
叮	(テイ)
町	(チョウ)〜(まち)『チャウ『チヤウ
甼	(チョウ)〜(みち)
疔	(テイ)(チョウ)『チヤウ
釘	(テイ)(チョウ)〜(くぎ)
酊	(テイ)〜(よう)
頂	(チョウ)〜(いただ・く)(いただき)『チャウ
鼎	(テイ)〜(かなえ)『へ
定	(テイ)(ジョウ)〜(さだ・める)(さだ・まる)(さだ・か)(さた)『ヂャウ『ヂヤウ
訂	(テイ)『ただす
碇	(テイ)〜(いかり)
聢	(しか)(しかと)
錠	(ジョウ)『ヂャウ『ヂヤウ｜ジヤウ
冬	(トウ)〜(ふゆ)
苳	(トウ)〜(ふき)
東	(トウ)〜(ひがし)(あい)(あがり)(あずま)(あづま)(こ)(さき)(しの)(とお)(はる)(ひが)(もと)『ひむかし『ひんがし
鮗	(このしろ)
鼕	(トウ)
鶇	(トウ)(ツ)〜(つぐみ)
鶫	(トウ)(ツ)〜(つぐみ)
董	(トウ)〜(ただ・す)
諌	(カン)〜(いさ・め)(いさ・める)
洞	(ドウ)〜(ほら)(とう)『うつお『うつほ『うつろ『うろ
恫	(ドウ)(トウ)〜(いた・む)
胴	(ドウ)
凍	(トウ)〜(こお・る)(こご・える)(こご・る)(い・てる)(し・みる)(こおり)
凍り	こおり『こほり
動	{動}働。(ドウ)〜(うご・く)(うご・かす)(るぎ)『ドウẎ『はたらく『ややもすれば
棟	(トウ)〜(むね)(むな)
働	{動}働。(ドウ)(リュク)(リキ)(ロク)(リョク)〜(はたら・く)『ドウẎ
都	〔都〕都。(ト)(ツ)〜(みやこ)(くに)(ず)(ち)(づめ)(みや)
兜	(トウ)(ト)〜(かぶと)
抖	(ト)(トウ)
蚪	(ト)
斗	{鬥}斗。(ト)(トウ)〜(ます)(とます)
斗掻き	とかき
豆	{豆}荳。(トウ)(ズ)〜(まめ)(まめ)(ど)(ま)『ヅ
荳	{豆}荳。(トウ)(ズ)〜(まめ)
逗	(トウ)(ズ)〜(とど・まる)
鬥	{鬥}斗。(とうがまえ)(たたかいがまえ)『たたかう『ト『トウ『とます『ます
鬥搔き	とかき
酘	(トウ)
痘	(トウ)『もがさ
闘	{鬥}闘。(トウ)〜(たたか・う)(あらそ・う)(と)
鬪	(トウ)〜(たたか・う)(あらそ・う)
竇	(トウ)(トク)〜(あな)
鬭	{鬥}鬭。たたかう『トウ
督	(トク)〜(ただ)(ただし)『かみ
闍	(ト)(ジャ)
毒	(ドク)
独	〔獨〕独。(ドク)(トク)〜(ひと・り)(どいつ)(どっ)
涜	{瀆}涜。(トク)(トウ)〜(けが・す)(けが・れ)(みぞ)
読	{讀}読。(ドク)(トク)(トウ)〜(よ・む)(よ・み)(よみ)
獨	〔獨〕独。(ドク)(トク)〜(ひと・り)
瀆	{瀆}涜。トク
犢	(トク)〜(こうし)
犢鼻褌	たふさぎ『とうさぎ『ふどし『ふんどし
牘	(トク)〜(かきもの)(ふだ)
髑	(ドク)(トク)
讀	{讀}読。(ドク)(トク)(トウ)〜(よ・む)
黷	(トク)〜(けが・す)(けが・れる)
堵	(ト)〜(かき)
睹	(ト)〜(み・る)
覩	(ト)〜(み・る)
賭	(ト)〜(か・ける)(かけ)
篤	(トク)〜(あつ・い)
杜	(ト)(トウ)(ズ)〜(もり)(ふさ・ぐ)(やまなし)『ヅ
杜父魚	かじか
杜松	むろ
肚	(ト)〜(はら)
妒	{妒}妬。そねむ『ト『ねた『ねたむ『やく
妬	{妒}妬。(ト)(ツ)〜(ねた・む)(そね・む)(つも・る)(ふさ・ぐ)『ねた『やく
度	(ド)(ト)(タク)〜(たび)(た・い)(のり)『たんび『はかる『より
渡	(ト)〜(わた・る)(わた・る)(わた・す)(お)(たり)(わたな)(わたら)(わたり)
鍍	(ト)〜(めっき)
蠧	(ト)〜(きくいむし)
蠹	(ト)〜(きくいむし)
端	(タン)〜(はし)(は)(はた)(ばた)(はな)(ただし)(みず)『つま『はじ『はした『へた
短	(タン)〜(みじか・い)『みじか
段	(ダン)(タン)『きざ『きだ
段階	きざはし『きだはし
断	{斷}断。(ダン)〜(た・つ)(ことわ・る)(さだ・める)
葮	(ダン)(タン)〜(むくげ)
椴	(タン)(ダン)(トド)〜(むくげ)
緞	(ドン)(タン)
鍛	(タン)〜(きた・える)(か)
斷	{斷}断。(ダン)〜(た・つ)(ことわ・る)(さだ・める)
堆	(タイ)(ツイ)〜(うずたか・い)
兌	(ダ)(エイ)(エツ)(タイ)〜(よろこ・ぶ)(で)
対	{對}対。(タイ)(ツイ)〜(あいて)(こた・える)(そろ・い)(つれあ・い)(なら・ぶ)(むか・う)(つし)
隊	(タイ)
碓	(カク)(タイ)〜(たし・か)(かく・たる)(う)(うす)
對	{對}対。(タイ)(ツイ)〜(あいて)(こた・える)(そろ・い)(つれあ・い)(なら・ぶ)(むか・う)(つし)
惇	(シュン)(ジュン)(トン)〜(あつ・い)(あつし)(あつ)(まこと)(とし)(つとむ)
敦	(トン)(タイ)(ダン)(チョウ)〜(あつ・い)(あつ)(あつし)(つる)(のぶ)(のり)
墩	とん
噸	(トン)
燉	(トン)
蹲	(ソン)(シュン)〜(つくば・う)(うずくま・る)『つくばい『つくばひ
蹲踞	つくばい『つくばひ
鐓	(タイ)〜(いしづき)
沌	(トン)〜(くら・い)
盾	(ジュン)〜(たて)
遁	(トン)(シュン)〜(のが・れる)
鈍	(ドン)〜(にぶ・い)(にぶ・る)(にぶ)(なま・る)(なまく・ら)『おそ『にび『のろ『のろい
楯	(ジュン)〜(たて)『たた
頓	(トン)(トツ)〜(にわか・に)(とん・と)(つまず・く)(とみ・に)(ぬかずく)『とみ『ひたすら『ひたぶる
遯	(トン)〜(のが・れる)
多	(タ)〜(おお・い)(まさ・に)(まさ・る)『さは『さわ
夛	(タ)〜(おお・い)(まさ・に)(まさ・る)
咄	(トツ)〜(はなし)(しか・る)(はな)
鈬	(タク)
奪	(ダツ)〜(うば・う)
鐸	(タク)〜(すず)『さなき『ぬて『ぬりて
朵	{朵}朶。ダ
朶	{朵}朶。(ダ)(タ)〜(えだ)
躱	(タ)〜(かわ・す)
陏	(ダ)〜(ずい)
柮	(トツ)
舵	(ダ)(タ)〜(かじ)『かぢ
堕	〔墮〕堕。(ダ)〜(お・ちる)(くず・す)(くず・れる)『おとす
惰	(ダ)
墮	〔墮〕堕。(ダ)〜(おち・る)(くず・す)(くず・れる)『おとす
婀	(ア)〜(あだ)(あだ・っぽい)(たおやか)
囮	(カ)(ユウ)〜(おとり)『を
俄	(ガ)〜(にわか)『にはか
莪	(ガ)
峨	(ガ)〜(けわ・しい)
峩	(ガ)〜(けわ・しい)
娥	(ガ)〜(みめよ・い)
訛	(カ)〜(なま・る)(なま・り)(あやま・る)『クヮ
蛾	(ギ)(ガ)〜(ひむし)『ひいる『ひひる
鵝	(ガ)
鵞	(ガ)
額	(ガク)〜(ひたい)(ぬか)『ひたひ
譌	(カ)〜(なま・る)(あやま・る)
鵈	(とび)
厄	(ヤク)
阨	(ヤク)(アイ)(アク)〜(せま・い)(ふさが・る)(せま・る)
扼	(ヤク)(アク)〜(おさ・える)
咢	(ガク)〜(おどろく)
姶	(オオ)(オウ)(アイ)〜(あい)
堊	(アク)(ア)(オ)〜(いろつち)(しろつち)
軛	(ヤク)(アク)〜(くびき)
悪	{惡}悪。(アク)(オ)〜(わる・い)(わる)(あ・し)(にく・い)(にく・い)(ああ)(いずくに)(いずくんぞ)(にく・む)『ヲ
鄂	(ガク)
惡	{惡}悪。(アク)(オ)〜(わる・い)(あ・し)(にく・い)(ああ)(いずくに)(いずくんぞ)(にく・む)『わる『ヲ
萼	(ガク)〜(うてな)
遏	(アツ)〜(とど・める)(と・める)
愕	(ガク)〜(おどろ・く)
腭	あぎ『あご
蕚	(ガク)〜(うてな)
餓	(ガ)〜(う・える)『かつえる
諤	(ガク)〜(わめ・く)(あご)
鍔	(ガク)〜(つば)『つみは
顎	(ガク)〜(あご)(あぎと)『あぎ
顎門	あぎと
鶚	(ガク)〜(みさご)
鰐	(ガク)〜(わに)
齶	(ガク)〜(あご)(はぐき)
恩	(オン)〜(めぐみ)
儿	(ジン)(ニン)〜(がい)(にんにょう)(ひとあし)
而	(ジ)(ニ)〜(しこ・うして)(しか・して)(しか・も)(しか・れども)(すなわち)(なんじ)(しかるに)
児	{兒}児。(ジ)(ニ)(ゲイ)〜(こ)(こ)(っこ)(る)『ちご『やや
兒	{兒}児。(ジ)(ニ)(ゲイ)〜(こ)(ちご)『やや
粫	(メン)
轜	(ジ)〜(ひつぎぐるま)(じしゃ)
尓	(ジ)(ニ)〜(なんじ)(しかり)(その)(のみ)
耳	(ジ)〜(みみ)(がみ)『ニ『のみ
耳廢	{耳廢}耳癈。しひ『みみしい
耳癈	{耳廢}耳癈。しひ『みみしい
迩	(ジ)(ニ)〜(ちか・い)(ちかし)
珥	(ジ)〜(みみだま)
爾	(ジ)(ニ)〜(なんじ)(しかり)(その)(のみ)(ちか)(しか)(み)『おれ『それ『んぢ
餌	(ジ)(ニ)〜(え)(えば)(えさ)(もち)『ゑ
邇	(ジ)(ニ)〜(ちか・い)
二	(ニ)(ジ)〜(ふた)(ふた・つ)(ふたた・び)(おと)(つぐ)(にい)(は)(ふ)(ふたつ)(ふだ)(わ)『アル『ふう
二十	はたち
二十歲	{二十歲}二十歳。はたち
二十歳	{二十歲}二十歳。はたち
弍	(ニ)(ジ)〜(ふた)(ふた・つ)(ふたた・び)
弐	{貳}弐。(ニ)(ジ)〜(ふた・つ)(そえ)『すけ
貮	(ニ)(ジ)〜(ふた・つ)(そえ)
貳	{貳}弐。(ニ)(ジ)〜(ふた・つ)(そえ)『すけ
発	{發}発。(ハツ)(ホツ)〜(た・つ)(あば・く)(おこ・る)(つか・わす)(はな・つ)(ば)(わ)『ひらく
發	{發}発。(ハツ)(ホツ)〜(た・つ)(あば・く)(おこ・る)(つか・わす)(はな・つ)(ば)『ひらく
廢	{廢}癈。(ハイ)〜(すた・れる)(すた・る)『しい『しひ
醗	{醱}醗。(ハツ)〜(かも・す)
乏	(ボウ)〜(とぼ・しい)(とも・しい)『ボフ
伐	(バツ)(ハツ)(カ)(ボチ)〜(き・る)(そむ・く)(う・つ)
筏	(バツ)(ハツ)(ボチ)〜(いかだ)
閥	(バツ)
罰	(バツ)(バチ)(ハツ)〜(ばっ・する)
罸	(バツ)(バチ)(ハツ)〜(はっ・する)
法	(ホウ)(ハッ)(ホッ)(フラン)〜(のり)(ほ)『のっとる『ハフ『ホフ
琺	(ホウ)
髪	{髮}髪。(ハツ)〜(かみ)(がた)(ひげ)『くし
髮	{髮}髪。(ハツ)〜(かみ)『くし
帆	(ハン)〜(ほ)
番	(バン)〜(つが・い)(は)(ま)『つがう
蕃	(バン)(ハン)〜(しげ)(しげる)(ば)
幡	(マン)(ハン)(バン)(ホン)〜(はた)(は)(わた)
旙	(ヘン)(ハン)〜(はた)
藩	(ハン)
翻	{翻}繙。(ホン)(ハン)〜(ひるがえ・る)(ひるがえ・す)『ひもとく
旛	(ヘン)(ハン)〜(はた)(ば)
飜	〔飜〕翻。(ハン)(ホン)〜(ひるが・えす)(ひるが・える)
凡	(ボン)(ハン)〜(およ・そ)(おうよ・そ)(すべ・て)(なみ)(ひろ)(みな)『おお『おおし『おおよそ『おほ『おぼ『おほし
籵	(デカメートル)
煩	(ハン)(ボン)〜(わずら・う)(わずら・わす)
樊	(ハン)〜(まがき)
膰	(ハン)〜(ひもごり)(ひもろぎ)
燔	(ハン)〜(や・く)
繁	〔繁〕繁。(ハン)〜(しげ・る)(しげ・く)『しげ『しげし
繙	{翻}繙。(ハン)(ホン)〜(ひもと・く)
礬	(バン)(ハン)
鐇	(ハン)『たつぎ
鷭	(ハン)(バ)〜(ばん)
攵	(ホク)〜(のぶん)(ぼくづくり)(ぼくにょう)
反	(ハン)(ホン)(タン)(ホ)〜(そ・る)(そ・らす)(かえ・す)(かえ・る)(かえ・る)(そり)(た)『かえって
払	〔拂〕払。(フツ)(ヒツ)(ホツ)〜(はら・う)(はら・い)(ばら・い)(はらい)
辺	{邊}辺。(ヘン)〜(あた・り)(ほと・り)(べ)(なべ)『へ『へた
仮	{假}仮。(カ)(ケ)〜(かり)(かり)
返	(ヘン)〜(かえ・す)(かえ・す)(かえ・る)(かえ・る)
犯	(ハン)(ボン)〜(おか・す)
氾	(ハン)〜(ひろ・がる)
汎	{泛}汎。(ハン)(ブ)(フウ)(ホウ)(ホン)〜(ただよ・う)(ひろ・い)(ひろ)(ひろし)(みな)
泛	{泛}汎。(ハン)(ホウ)〜(うか・ぶ)
范	{范}範。(ハン)〜(いがた)『のり
梵	(ボン)(フウ)
販	(ハン)『ひさぐ
笵	(ハン)(ボン)〜(のり)
飯	(ハン)〜(めし)(い)(いい)(いり)(え)『いひ『ボン『まま『まんま
飯櫃	いびつ
範	{范}範。(ハン)〜(のり)
匚	(ホウ)〜(はこがまえ)
方	(ホウ)〜(かた)(かた)(がた)(から)(な)(なた)(ふさ)(まさ)(みち)(も)(わ)『え『けた『さま『ハウ『へ『べ『まさに
坊	(ボウ)(ボッ)『バウ『ぼん
芳	(ホウ)〜(かんば・しい)(お)(かおる)(は)(ほ)(みち)(やす)(よし)『ハウ
枋	(ホウ)(ヘイ)〜(ほ)
錺	(かざり)
防	(ボウ)〜(ふせ・ぐ)(あた)(う)(ほう)『つつみ『バウ
妨	(ボウ)〜(さまた・げる)『バウ
肪	(ボウ)『あぶら『バウ
房	(ボウ)〜(ふさ)(お)(のぶ)(わ)『ハウ『バウ『ホウ
魴	(ホウ)〜(かがみたい)(おしきうお)(かがみだい)
仿	{仿}倣。ならう『ハウ『ホウ
倣	{仿}倣。(ホウ)〜(なら・う)『ハウ
舫	(ホウ)〜(もや・う)(もやいぶね)
紡	(ボウ)〜(つむ・ぐ)『バウ
紡錘	つむ
訪	(ホウ)〜(おとず・れる)(たず・ねる)(と・う)(わ)『ハウ
髣	(ホウ)
放	(ホウ)〜(はな・す)(っぱな・し)(はな・つ)(はな・れる)(こ・く)(ほう・る)(はなれ)『ハウ
妃	(ヒ)〜(きさき)(き)(ぴ)(み)『きさい『みめ
非	(ヒ)〜(あら・ず)『そしる
飛	(ヒ)〜(と・ぶ)(と・ばす)(と・ばす)(あす)(とび)
飛ぶ火	とぶひ
飛白	かすり
飛蝗	ばった
飛礫	つぶて
菲	(ヒ)〜(うす・い)
暃	(ヒ)
扉	(ヒ)〜(とびら)
蜚	(ヒ)〜(あぶらむし)
緋	(ヒ)〜(あけ)(あか)
霏	(ヒ)〜(もや)
鯡	(ヒ)〜(にしん)(はららご)
肥	(ヒ)〜(こ・える)(こえ)(こ・やす)(こ・やし)(ふと・る)(い)(こい)(ひえ)
腓	(ヒ)〜(ふくらはぎ)(こむら)(こぶら)
朏	(ヒ)(ハイ)〜(みかづき)
匪	(ヒ)〜(あら・ず)(かたみ)
斐	(ヒ)(イ)〜(あや)
榧	(ヒ)〜(かや)
翡	(ヒ)
誹	(ヒ)(ハイ)〜(そし・る)
吠	(ハイ)(ベイ)〜(ほえ・る)(ほ・える)
肺	(ハイ)
狒	(ヒ)〜(ひひ)
沸	(フツ)〜(わ・く)(わ・かす)『にえ
廃	〔廢〕廃。(ハイ)〜(すた・れる)(すた・る)
費	(ヒ)〜(つい・やす)(つい・える)『あたい『あたえ『あたひ『あたへ
癈	{廢}癈。(ハイ)『しい『しひ
分	(ブン)(フン)(ブ)〜(わ・ける)(わ・け)(わ・かれる)(わ・かる)(わ・かつ)(いた)(わけ)
芬	(フン)〜(かおり)(こうば・しい)
吩	(フン)〜(ふ・く)
瓰	(デシグラム)
氛	{氛}雰。(フン)
竕	(デシリットル)
紛	(フン)〜(まぎ・れる)(まぎ・れ)(まぎ・らす)(まぎ・らわす)(まぎ・らわしい)『まがう
雰	{氛}雰。(フン)
汾	(フン)
枌	(ショウ)(フン)〜(まつ)(そぎ)
焚	(フン)(ホン)(ハン)〜(た・く)(や・く)(やきがり)
粉	(フン)(デシメートル)〜(こ)(こな)
忿	(フン)〜(いか・る)(いかり)
墳	(フン)
憤	(フン)〜(いきどお・る)
奮	(フン)〜(ふる・う)
糞	(フン)〜(くそ)『ばば
封	(フウ)(ホウ)『ふ
風	(フウ)(フ)〜(かぜ)(かざ)(かぜ)(い)(え)『て『ふり
峯	(ホウ)〜(みね)(ね)
峰	(ホウ)〜(みね)(ね)(ぶ)(ほ)『お『フ『を
烽	(ホウ)〜(のろし)(とぶひ)
楓	(フウ)〜(かえで)『おかつら『かつら『かへで
蜂	(ホウ)〜(はち)(ほ)
瘋	(フウ)
鋒	(ホウ)〜(ほこ・さき)『きっさき『ほこ
豐	{豐}豊。(ホウ)(ブ)〜(ゆた・か)(とよ)
逢	(ホウ)〜(あ・う)(むか・える)(あい)(おう)
馮	(ヒョウ)(フ)(フウ)〜(たの・む)(よ・る)
縫	(ホウ)〜(ぬ・う)(ぬい)
諷	(フウ)〜(そら・んじる)
奉	(ホウ)(ブ)〜(たてまつ・る)(まつ・る)(ほう・ずる)(とも)(やす)
俸	(ホウ)
鳳	(ホウ)(フウ)〜(おおとり)(ふげ)
仏	{佛}仏。(ブツ)(フツ)〜(ほとけ)
佛	{佛}仏。(ブツ)(フツ)〜(ほとけ)(さらぎ)
梻	しきび『しきみ
缶	〔罐〕缶。(カン)〜(かま)(ふ)(べ)(ほとぎ)『クヮン『クワン
否	(ヒ)〜(いな)(いや)『ふ
夫	(フ)(フウ)(ブ)〜(おっと)(そ・れ)(お)(と)(ゆう)(よ)『おうと『おとこ『おひと『せ『そ『ぢ『つま『ひこじ『を『をつと
麸	(フ)〜(ふすま)
趺	(シ)(フ)〜(あし)
稃	かい『かひ
筟	くだ
孵	(フ)〜(か・えす)『かえる
麩	{麩}麬。(フ)〜(ふすま)
敷	(フ)〜(し・く)(し・き)(しき)(にゅう)
敷き寝	しきね
敷き寢	しきね
敷き瓦	がはら『しきがわら
膚	(フ)〜(はだ)『はだえ『へ
麬	{麩}麬。ふすま
弗	(フツ)(ホチ)〜(どる)(ず)
伏	(フク)〜(ふ・せる)(ふ・す)(ふし)(ふせ)『ブク
扶	(フ)〜(たす・ける)
芙	(フ)〜(はす)
孚	(フ)〜(たまご)(はぐく・む)
拂	〔拂〕払。(ヒツ)(フツ)(ホツ)〜(はら・う)
苻	(フ)
彿	(フツ)
服	(フク)〜(はっ)(はつ)(はら)『ブク『ぷく
怫	(フツ)(ハイ)(ヒ)
茯	(フク)(ブク)(ヒ)(ビ)
枹	(フ)(ホウ)〜(ほ)(ばち)『なら
畉	(フ)〜(たがや・す)
罘	(フ)〜(うさぎあみ)
俘	(フ)〜(とりこ)
俘虜	とりこ
鳬	(フ)〜(けり)(かも)
郛	(フ)〜(くるわ)
祓	(フツ)(ハイ)〜(はら・う)『はらい『はらえ『はらひ『はらへ
莩	ひより
浮	(フ)〜(う・く)(う・かれる)(う・かぶ)(む)(う・かべる)(うき)『ブ
浮（き）草	うきくさ
浮き萍	うきくさ
桴	(フ)〜(ばち)(いかだ)
符	(フ)
匐	(ホク)(フク)
幅	(フク)〜(はば)『の『ぶく『ぷく
蜉	(フ)
鳧	(フ)〜(けり)(かも)
艀	(フ)〜(はしけ)
福	〔福〕福。(フク)〜(とし)(とみ)(ふ)(ふき)(ふっ)(ぼく)(よし)『さいわい
榑	(フ)〜(くれ)
箙	(フク)〜(えびら)
髴	(フツ)
蝠	(フク)
輻	(フク)〜(や)
黻	(フツ)〜(あや)
鮲	こち
甫	(ホ)(フ)〜(はじ・めて)(はじめ)(とし)(なみ)(すけ)(よし)
拊	(フ)〜(は・る)(うつ)(な・でる)
斧	(フ)〜(おの)『よき『をの
府	(フ)〜(い)(う)(お)(はん)
俯	(フ)〜(ふ・す)(うつむ・く)(ふ・せる)
釜	(フ)〜(かま)『かま
釡	(フ)〜(かま)
椨	(たぶ)(たふ)『たぶのき
腑	(フ)〜(はらわた)
輔	(ホ)(フ)〜(たす・ける)(すけ)(たすく)(ゆう)『つらがまち
輔車	つらがまち
腐	(フ)〜(くさ・る)(くさ・る)(くさ・れる)(くさ・れ)(くさ・らす)(くさ・す)
撫	(ブ)(フ)〜(な・でる)(なで)(なでし)(む)
黼	(フ)(ホ)〜(あや)
父	(フ)〜(ちち)『かぞ『しし『ち『ちゃん『てて『とと『ブ『ホ
付	(フ)〜(つ・ける)(つ・ける)(づ・ける)(つ・け)(つ・け)(つ・け)(づ・け)(づけ)(つ・く)(づ・く)(つ・き)(つ・き)(つき)(づ・き)(づき)(つけ)
附	(フ)〜(つ・ける)(つ・く)(ずき)(づけ)『ブ
坿	(フ)
咐	(フ)(ホ)
阜	(フ)(フウ)〜(おか)(ぎふのふ)『つかさ
赴	(フ)〜(おもむ・く)
柎	(フ)〜(うてな)
負	(フ)〜(ま・ける)(ま・かす)(お・う)『おぶう『ブ
訃	(フ)〜(しらせ)
副	(フク)〜(そい)(そえ)『すけ『そう『そえる
冨	(フ)(フウ)〜(と・む)(とみ)(と)
婦	(フ)〜(ね)『おんな『ブ『よめ
傅	(フ)〜(かしず・く)(つく)(もり)(でん)『めのと
復	(フク)〜(また)『かえす『かえる
富	(フ)(フウ)〜(と・む)(とみ)(と)(とん)(ふっ)
腹	(フク)〜(はら)
複	(フク)
賦	(フ)(ブ)〜(うた)
蝮	(フク)〜(まむし)『くちばみ『はみ
輹	(フク)〜(とこしばり)
鮒	(ホ)(フ)(ブ)〜(ふな)
縛	(バク)〜(しば・る)『いましめる
賻	(フ)
覆	(フク)〜(おお・う)(くつがえ・す)(くつがえ・る)『フウ
馥	(クク)(ヒョク)(フク)〜(か)(かお・る)『かおり
鰒	(フク)〜(あわび)(ふぐ)『あはび
袱	(フク)
伽	(カ)(ガ)(キャ)(ギャ)〜(とぎ)
呷	(コウ)〜(あお・る)(す・う)
垓	(ガイ)(カイ)〜(はて)
該	(ガイ)
改	(カイ)〜(あらた・める)(あらた・まる)
丐	(カイ)〜(こ・う)
乢	(ガイ)〜(たわ)(たお)
盖	(ガイ)(カイ)(コウ)〜(ふた)(けだ・し)(おお・う)(かさ)(かこう)
葢	(ガイ)(カイ)(コウ)〜(ふた)(けだ・し)(おお・う)(かさ)(かこう)
蓋	(ガイ)(カイ)(コウ)〜(ふた)(けだ・し)(おお・う)(かさ)(かこう)
概	〔槪〕概。(ガイ)〜(おうむ・ね)『おおむね『とかき
漑	(ガイ)(カイ)〜(そそ・ぐ)
槪	〔槪〕概。ガイ
甘	(カン)〜(あま・い)(あま・える)(あま・やかす)(うま・い)(かも)『あまんずる『うま
肝	(カン)〜(きも)
坩	(カン)〜(つぼ)
泔	ゆする
柑	(コン)(カン)
竿	(カン)〜(さお)『さを
疳	(カン)
扞	(カン)〜(ふせ・ぐ)
杆	{杆}桿。(カン)〜(てこ)
桿	{杆}桿。(カン)〜(てこ)
敢	(カン)〜(あ・えて)(あ・えない)(あ・えず)
稈	(カン)〜(わら)
稈心	みご
感	(カン)
橄	(カン)
干	(カン)〜(ほ・す)(ほ・し)(ぼ・し)(ひ・る)(ほし)『たて『ひ『ふ
干し飯	いひ『ほしいい
淦	(カン)(コン)〜(あか)
紺	(コン)
骭	(カン)〜(はぎ)
幹	(カン)〜(みき)(つよし)(まさ)(もと)『から
肛	(コウ)『カウ
矼	(コウ)〜(ばし)
岡	(コウ)〜(おか)『をか
缸	(コウ)〜(かめ)
剛	(ゴウ)〜(かた)(こう)(ご)(たか)(たけ)(たけし)(つよ)(つよし)(ひさ)(まさ)(よし)『カウ『ガウ
崗	(コウ)〜(おか)『カウ
棡	(コウ)
堽	(コウ)
綱	(コウ)〜(つな)『カウ
鋼	(コウ)〜(はがね)『カウ
港	(コウ)〜(みなと)『カウ
杠	{杠}槓。(コウ)〜(てこ)(ゆずりは)『カン
槓	{杠}槓。(コウ)〜(てこ)『カン
皋	{皋}皐。(コウ)〜(さつき)『カウ
高	(コウ)〜(たか・い)(たか)(だか)(たか・まる)(たか・める)(か)(こ)(じょい)(た)(はか)『カウ
羔	(コウ)〜(こひつじ)
皐	{皋}皐。(コウ)〜(さつき)(たかし)『カウ
睾	(コウ)
膏	(コウ)〜(あぶら)『カウ
槹	(コウ)
杲	(コウ)〜(あきらか)(たか・い)
槁	(コウ)〜(か・れる)
稿	(コウ)〜(わら)(したがき)『カウ
稾	(コウ)〜(わら)(したがき)
縞	(コウ)〜(しま)(しろぎぬ)
藁	(コウ)〜(わら)
鎬	(コウ)〜(しのぎ)(なべ)
告	(コク)〜(つ・げる)(い)『こう
告り言	のりごと
誥	(コウ)〜(つ・ぐ)
戈	(カ)〜(ほこ)(ほこづくり)(かのほこ)『クヮ『クワ
咯	(カク)〜(は・く)
哥	(カ)(コ)〜(あに)(うた)
割	(カツ)〜(わ・る)(わり)(わ・り)(わ・れる)(さ・く)
彁	(カ)(セイ)
歌	(カ)〜(うた)(うた・う)
擱	(カク)〜(お・く)
鴿	(コウ)〜(はと)(どばと)
謌	(カ)〜(うた)(うた・う)
挌	(カク)〜(う・つ)
革	(カク)〜(かわ)『あらたまる『あらためる『かは『つくりかわ
茖	(カク)
格	(カク)(コウ)(キャク)(ゴウ)〜(いたる)(のり)『いたす『カウ『ガウ『こ『ただす
鬲	(カク)(レキ)〜(かなえ)(へだ・てる)『へ
隔	(カク)〜(へだ・てる)(へだ・たる)
閤	(コウ)〜(くぐりど)『カフ
閣	(カク)『たかどの
膈	(カク)
骼	(カク)
臈	(ロウ)
舸	(カ)〜(ふね)
葛	(カツ)(カチ)〜(つづら)(くず)(か)(かず)(かずら)(かっ)(かつら)『かづら『くずかずら
葛籠	つづら
葛蔓	かづら『くずかずら
个	{個}个。(カ)(コ)
各	(カク)〜(おのおの)(かか)(かが)
各々	おのおの
個	{個}个。(コ)(カ)『じ『ち『ぢ『つ
箇	{個}箇。(カ)(コ)『じ『ち『ぢ『つ
給	(キュウ)〜(たま・う)(たも・う)(たま・え)(きい)『キフ
根	(コン)〜(ね)(ね)
跟	(コン)〜(くび・す)
亘	{亙}亘。(コウ)(カン)〜(わた・る)(もと・める)(せん)(のぶ)(とうる)(わたる)(ひさし)
亙	{亙}亘。(コウ)(カン)〜(わた・る)(もと・める)(のぶ)『セン
艮	(コン)(ゴン)〜(うしとら)(ねずくり)
庚	(コウ)〜(かのえ)『カウ
畊	(キョウ)(コウ)〜(たが・やす)
耕	(コウ)〜(たがや・す)(こお)『カウ
羮	(コウ)(カン)〜(あつもの)
羹	(コウ)(カン)〜(あつもの)
耿	(コウ)〜(ひかり)
哽	(コウ)〜(むせ・ぶ)
峺	(コ)
梗	(コウ)(キョウ)〜(ふさぐ)(やまにれ)(おおむね)『カウ『キャウ
鯁	のぎ
更	(コウ)〜(さら)(さら・に)(ふ・ける)(ふ・かす)『カウ『かえる『かわる『こもごも『ふけ
工	(コウ)(ク)(グ)〜(もく)(たくみ)
弓	(キュウ)〜(ゆみ)(こ)(ゆ)
弓柄	ゆづか『ゆみつか
弓束	ゆづか『ゆみつか
公	(コウ)(ク)〜(おおやけ)(あきら)(き)(きみ)(きん)(たか)(ただし)(とも)(ひろ)(まさ)『おほ
公卿	まえつきみ『まちぎみ『まへ
公魚	わかさぎ
功	(コウ)(ク)〜(いさお)(いさ)(かつ)(くぬ)(ぐう)(こと)(つとむ)(とし)(のり)(よし)『いさおし『いさを『くう
攻	(コウ)〜(せ・める)(おさむ)『おさめる
肱	(コウ)〜(かいな)(ひじ)(まるい)『かひな『ひぢ
恭	(キョウ)〜(うやうや・しい)(きよ)(やす)(やすし)(ゆき)(よし)
蚣	(コウ)(ショウ)
躬	(キュウ)(キョウ)〜(み)『みずから
宮	(キュウ)(グウ)(ク)(クウ)〜(みや)(ぐ)(み)
廾	(キョウ)(ク)〜(にじゅう)(にじゅうあし)
汞	(コウ)〜(みずがね)
拱	(キョウ)(コウ)〜(こまぬ・く)(こまね・く)
鞏	(キョウ)〜(かたい)
共	(キョウ)〜(とも)(とも・に)(ども)『ぐち『むた
供	(キョウ)(ク)(クウ)(グ)〜(そな・える)(とも)(ども)
貢	(コウ)(ク)〜(みつ・ぐ)
貢ぎ	みつぎ
熕	(コウ)
勾	(コウ)(ク)〜(かぎ)(ま・がる)(まがり)『とらえる
佝	(コウ)(ク)〜(せむし)
冓	(コウ)〜(かま・える)
鈎	(コウ)(ク)〜(かぎ)
鉤	(コウ)(ク)〜(かぎ)『こ『ち『はり
溝	(コウ)〜(みぞ)(どぶ)『うなて『せせなぎ『せせなげ
篝	(コウ)〜(かがりび)(かがり)(ふせご)
苟	(コウ)(ク)〜(いやしく・も)『まことに
狗	(ク)(コウ)〜(いぬ)『えのころ『ゑのこ
狗母魚	えそ
枸	(ク)(コウ)
垢	(コウ)(ク)〜(あか)(はじ)
遘	(コウ)〜(あ・う)(まみ・える)
搆	(コウ)
詬	(コウ)(ク)〜(ののし・る)(はじ)(はずかし・める)
媾	(コウ)〜(よしみ)
構	(コウ)〜(かま・える)(かま・う)(とち)『かじ『かぢ
覯	(コウ)〜(あ・う)
購	(コウ)『あがなう
估	(コ)〜(あきな・う)(あた・い)
沽	(コ)〜(あた・い)(あら・い)(う・る)
孤	(コ)『みなしご
孤児	{孤兒}孤児。みなしご
孤兒	{孤兒}孤児。みなしご
姑	(コ)〜(しゅうとめ)(しゅうと)(おば)(しばらく)『しうと『しうとめ
柧	(コ)(カ)〜(く)
菰	(コ)〜(こも)(まこも)
蛄	(コ)
辜	(コ)〜(つみ)
觚	(コ)〜(さかずき)
箍	(コ)〜(たが)
鴣	(コ)
轂	(コク)〜(こしき)
古	(コ)〜(ふる・い)(ふる)(ふる・す)(ふゆ)『いにしえ『へ
谷	(コク)〜(たに)(きわ・まる)(がい)(がえ)(がや)(せ)(たり)(たん)(や)『さこ『やつ『やと
股	(コ)〜(また)(もも)
骨	(コツ)〜(ほね)
罟	(コ)〜(あみ)
逧	(サコ)(セコ)
詁	(コ)〜(よみ)
鼓	(コ)〜(つづみ)
榾	(コツ)〜(ほた)
榾柮	ほた
鈷	(コ)
皷	(コ)〜(つづみ)
榖	かじ『かぢ
穀	〔穀〕穀。(コク)〜(たけ)『たなつもの
瞽	(コ)〜(めし・い)『めくら
鶻	(コツ)(カツ)〜(はやぶさ)
蠱	(コ)(ヤ)『まじ
固	(コ)〜(かた・める)(かた・まる)(かた・まり)(かた・い)『もとより
固まり	かたまり
故	(コ)〜(ゆえ)『え『から『かれ『け『ことさら『ふる『ふるい『もと『ゆゑ『ゑ
凅	(コ)(カク)〜(か・れる)(か・らす)(こお・る)
梏	(コク)(カク)〜(てかせ)
雇	{僱}雇。(コ)〜(やと・う)
痼	(コ)
僱	{僱}雇。コ『やとう
錮	(コ)〜(ふさ・ぐ)
顧	(コ)〜(かえり・みる)(たか)(み)『かえって
瓜	(カ)(ケ)〜(うり)(う)『クヮ
呱	(コ)
刮	(カツ)〜(こそ・げる)(けず・る)『クヮツ
颪	(おろし)
寡	(カ)『クヮ『クワ『すくない『やもめ
寡婦	やもめ
卦	(カ)(カイ)(ケ)〜(うらかた)
挂	(ケイ)(カイ)(ケ)〜(か・ける)
掛	(カイ)(ケイ)〜(か・ける)(か・ける)(か・け)(か・け)(が・け)(か・かる)(か・かる)(が・かる)(か・かり)(が・かり)(かかり)(がかり)(かけ)『かける
掛（け）橋	かけはし
絓	しけ
罫	(ケイ)(カイ)(ケ)
褂	(ケイ)(カイ)(ケ)〜(うちき)(うちかけ)
乖	(カイ)〜(そむ・く)(もとる)
拐	(カイ)
枴	(カイ)〜(つえ)
怪	{怪}恠。(カイ)(ケ)〜(あや・しい)(あや・しむ)『クヮイ『クワイ『しるまし
恠	{怪}恠。(カイ)(ケ)〜(あや・しい)(あや・しむ)
官	(カン)『クヮン『クワン『つかさ
蒄	(カン)
棺	(カン)『クヮン『クワン『ひつぎ『ひとき
関	{關}関。(カン)〜(せき)(ぜき)(かか・わる)(からくり)(かんぬき)『あずかる『クヮン『クワン
観	{觀}観。(カン)〜(み・る)(しめ・す)『クヮン『クワン『みせる
關	{關}関。(カン)〜(せき)(かか・わる)(からくり)(かんぬき)『あずかる『クヮン『クワン『ぜき
鰥	(カン)(コン)〜(やもめ)(やもお)
鰥夫	やもめ
觀	{觀}観。(カン)〜(み・る)(しめ・す)『クヮン『クワン『みせる
欟	(つき)
莞	(カン)〜(い)『クヮン『ふとい『ゐ
管	(カン)〜(くだ)(すが)『クヮン『クワン
舘	(カン)〜(やかた)(たて)(たち)
館	〔館〕館。(カン)〜(やかた)(たて)(たち)『クヮン『クワン
丱	(カン)(ケン)
冠	(カン)〜(かんむり)(か)(かっぷ)(まさる)『かうぶり『かがふり『かぶり『かぶる『かむり『クヮン『クワン『こうぶり『さか
貫	(カン)〜(つらぬ・く)(ぬ・く)(ぬき)(つら)(ぬく)『クヮン『クワン
貫木	かんぬき『クワン
潅	(カン)〜(そそ・ぐ)
慣	(カン)〜(な・れる)(な・らす)『クヮン
樌	(カン)〜(ぬき)
盥	(カン)〜(たらい)(そそ・ぐ)『たらひ
灌	(カン)〜(そそ・ぐ)『クヮン
罐	{罐}鑵。(カン)〜(かま)(ふ)(べ)『クヮン『クワン
鑵	{罐}鑵。(カン)〜(かま)『クワン
鸛	(カン)〜(こうのとり)『こふ
光	(コウ)〜(ひか・る)(ひかり)(あき)(あきら)(こお)(てる)(ひこ)(み)(みつ)『クヮウ
洸	(コウ)〜(ひろ)(ひろし)(たけし)(ひかり)『クヮウ
胱	(コウ)
广	(ゲン)〜(まだれ)
広	〔廣〕広。(コウ)〜(ひろ・い)(ひろ・まる)(ひろ・める)(ひろ・がる)(ひろ・げる)『クヮウ
廣	〔廣〕広。(コウ)〜(ひろ・い)(ひろ・まる)(ひろ・める)(ひろ・がる)(ひろ・げる)『クヮウ
𥶡	たが
圭	{圭}珪。(ケイ)(ケ)〜(か)(きよ)(たま)(よし)(かど)(きよし)
皈	(キ)〜(かえ・る)(かえ・す)(おく・る)(とつ・ぐ)
珪	{圭}珪。(ケイ)〜(たま)
帰	〔歸〕帰。(キ)〜(かえ・る)(かえ・す)(おく・る)(とつ・ぐ)
規	(キ)〜(すのり)(ただし)(のり)(み)
硅	(カク)(キャク)(ケイ)〜(やぶ・る)
亀	{龜}亀。(キ)(キュウ)(キン)〜(かめ)(ひさ)(ひさし)
袿	(ケイ)〜(うちき)(うちかけ)(うちぎ)
瑰	(カイ)〜(たま)(めずら・しい)
閨	(ケイ)(ケ)〜(ねや)
槻	(キ)〜(つき)『けやき
龜	{龜}亀。(キ)(キュウ)(キン)〜(かめ)(ひさし)
鮭	(カイ)(ケイ)〜(さけ)(しゃけ)(ふぐ)
竃	(ソウ)〜(かまど)(かま)(へっつい)
歸	〔歸〕帰。(キ)〜(かえ・る)(かえ・す)(おく・る)(とつ・ぐ)
軌	(キ)『わだち
鬼	(キ)〜(おに)(おに)
癸	(キ)〜(みずのと)『みづ
詭	(キ)〜(いつわ・る)『たがう
簋	き
桂	(ケイ)〜(かつら)(かつ)(よし)(か)
桧	(カイ)〜(ひのき)(ひ)
椢	(カイ)〜(そこ)(はこ)(くぬぎ)
貴	(キ)〜(たっと・い)(とうと・い)(たっと・ぶ)(とうと・ぶ)(きよ)(ぎ)(たか)(たかし)(よし)『あて『むち
跪	(キ)〜(ひざまず・く)
瞶	(キ)
櫃	(キ)〜(ひつ)
袞	(コン)
滾	(コン)〜(たぎ・る)(たぎ・らかす)
鯀	(コン)
棍	(コン)〜(つえ)
郭	(カク)〜(くるわ)(ひろ)『クヮク『クワク
聒	(カツ)〜(かまびす・しい)
鍋	(カ)〜(なべ)『なべ
国	{國}国。(コク)〜(くに)(くな)(こ)
圀	(コク)〜(くに)(こつ)
掴	(カク)〜(つか・む)(つか・まえる)(つか・まる)
國	{國}国。(コク)〜(くに)(こ)
幗	(カク)
馘	(カク)(キョク)〜(くびき・る)(みみき・る)『クヮク
果	{果}菓。(カ)〜(は・たす)(はた・す)(は・たす)(は・てる)(は・てる)(は・て)(み)『クヮ『クワ『はか
果たて	はたて
菓	{果}菓。(カ)『クヮ
椁	(カク)
槨	(カク)『クワク
裹	(ホウ)(カ)〜(つつ・む)『くぐつ
過	(カ)〜(す・ぎる)(す・ぎる)(す・ぎ)(す・ごす)(あやま・つ)(あやま・ち)『クヮ『クワ『よぎる
哈	(ゴウ)(ハ)(ソウ)
蛤	(コウ)〜(はまぐり)『かえる『かへる『はま
孩	(ガイ)(カイ)〜(ちのみご)
骸	(ガイ)(カイ)〜(むくろ)『から
還	(カン)〜(かえ・る)『かえす『クヮン『ゲン
海	〔海〕海。(カイ)〜(うみ)(あ)(あま)(うな)(うん)(え)(か)(た)(ひろ)(ひろし)(ぶ)(まち)(まま)(み)(め)(わたる)『わた
海<img src="resource00057.gif">	ばい
海老	えび
海螺	つぶ
海女	あま
海人	あま
海石榴	つばき
海士	あま
海鷂魚	えい『えひ
塰	(あま)
醢	(カイ)〜(ひしお)(ししびしお)(しおから)『しほ『びしほ
亥	(ガイ)(カイ)〜(い)(り)『ゐ
害	(ガイ)『そこなう
駭	(ガイ)(カイ)〜(おどろ・く)(おどろ・かす)
蚶	(カン)
酣	(カン)〜(たけなわ)『たけなは
鼾	(カン)〜(いびき)
邯	(カン)
含	(ガン)〜(ふく・む)(ふく・める)
函	(カン)〜(はこ)(い・れる)
凾	(カン)〜(はこ)(い・れる)
涵	(カン)〜(ひた・す)
寒	(カン)〜(さむ・い)(さ)(さん)『さぶ『さむ
韓	(カン)〜(から)(いげた)
罕	(カン)〜(まれ)
喊	(カン)(ヤク)〜(さけ・ぶ)
汗	(カン)〜(あせ)
旱	(カン)〜(ひでり)
捍	(カン)〜(ふせ・ぐ)
莟	{菡}莟。(ガン)(カン)〜(つぼみ)
悍	(カン)〜(たけし)(あらし)
菡	{菡}莟。つぼみ
漢	〔漢〕漢。(カン)〜(はん)『あや『から
撼	(カン)〜(うごか・す)
翰	(カン)〜(はね)(ふで)(やまどり)(ふみ)
頷	(ガン)(カン)〜(うなず・く)(あご)
澣	(カン)〜(あら・う)
憾	(カン)〜(うら・む)『うらみ
駻	(カン)
瀚	(カン)〜(ひろ・い)(なみ)
行	(コウ)(ギョウ)(アン)〜(い・く)(ゆ・く)(ゆ・き)(ゆき)(い・き)(いき)(おこな・う)(おこ・なう)(いく)(なみ)(なめ)(みち)(ゆき)(ゆく)『カウ『ギャウ『ギヤウ『くだり
行李	カウ『こうり
行潦	にはたづみ『にわたずみ
杭	(コウ)〜(くい)(わたる)『くいぜ『くひ『くひぜ
垳	(ガケ)〜(いけ)
航	(コウ)〜(わたる)『カウ『かはら『かわら
絎	{絎}裄。(コウ)〜(く・れる)(く・ける)『ゆき
頏	(コウ)〜(のど)
蒿	(コウ)〜(よもぎ)
嚆	(コウ)〜(さけ・ぶ)
竓	(ミリリットル)
毫	(ゴウ)(コウ)〜(ごう・も)(すこし)『ガウ
豪	(ゴウ)〜(えら・い)(こう)(ご)(すぐる)(たけ)(たけし)(ひで)(まさる)『えら『ガウ『つよい
壕	(コウ)(ゴウ)〜(ほり)『ガウ
濠	(ゴウ)(コウ)〜(ほり)『ガウ
好	(コウ)〜(この・む)(す・く)(よ・い)(い・い)(こ)(たか)(とし)(よし)『カウ『よしみ
号	{號}号。(ゴウ)〜(さけ・ぶ)(よびな)『ガウ
昊	(コウ)〜(そら)
耗	(モウ)(コウ)(カウ)
浩	(コウ)〜(おおき・い)(ひろ・い)(ひろ)(ひろし)(ゆたか)(こお)『カウ
晧	(コウ)
皓	(コウ)〜(しろ・い)(ひか・る)(あきら)(てる)(あき)(ひろ)(ひろし)『カウ
號	{號}号。(コウ)〜(さけ・ぶ)(よびな)『ガウ『ゴウ
呵	(カ)〜(か・す)(しか・る)(わら・う)
喝	〔喝〕喝。(カツ)
訶	(カ)〜(しか・る)(せ・める)
禾	(カ)〜(いね)(のぎ)(のぎへん)『クヮ
合	(ゴウ)(ガッ)(カッ)〜(あ・う)(あ・う)(あ・い)(あい)(あ・い)(あい)(あ・わす)(あ・わせる)(あ・わせる)(あう)(あん)(い)(か)(こう)(ごお)(に)(ね)(や)(り)(わい)『カフ『ガフ
何	(カ)〜(なに)(なん)(なに)(なん)(あが)『いず『いずれ『いづ『な『なんぞ
何某	なにがし
和	(ワ)(オ)(カ)〜(やわ・らぐ)(やわ・らげる)(なご・む)(なご・やか)(あい)(いず)(かず)(かつ)(かつり)(かづ)(たけ)(ち)(とも)(な)(にぎ)(まさ)(やす)(よし)(より)(わだこ)(わっ)『あえる『（ヲ）『クヮ『なぎ『なぐ『にき『にこ『のど
和ぎ	なぎ
和幣	にきて
劾	(ガイ)
河	(カ)〜(かわ)(かっ)(こ)(こう)『かは
河豚	ふぐ
河原	かはら『かわら
曷	(カツ)〜(なんぞ)(いつ)(いずくんぞ)(なに)
狢	{貉}狢。(カク)(ハク)(バク)〜(むじな)『もじな
盍	(コウ)〜(おお・う)(なんぞ)
荷	(カ)〜(に)(はす)(り)『になう
核	(カク)『さね『ざね
啝	(ワ)
盒	(コウ)〜(さら)(ふたもの)『ガフ『ゴウ
渮	(カ)
涸	(コ)(カク)〜(か・れる)(か・らす)(こお・る)
粭	(すくも)
鞨	(カツ)(ガチ)(セツ)(ゼチ)〜(かわぐつ)
闔	(コウ)〜(とびら)
覈	(カク)(ケツ)〜(しら・べる)
寉	(つる)
賀	(ガ)〜(か)(のり)(よし)(より)
赫	(カク)〜(あかい)(あか)(かがや・く)
褐	〔褐〕褐。(カツ)『カチ『かちん
壑	(ガク)(カク)〜(たに)
鶴	(カク)〜(つる)(たず)(ず)(か)(つ)(づ)『たづ『つる
黒	{黑}黒。(コク)〜(くろ)(くろ・ずむ)(くろ・い)
黑	{黑}黒。くろ『くろい『コク
痕	(コン)〜(あと)
很	(コン)(コウ)(ギン)〜(もと・る)
狠	(ガン)(ゲン)(コン)〜(もと・る)
恨	(コン)〜(うら・む)(うら・めしい)
亨	(コウ)(キョウ)(ホウ)〜(たてまつ・る)(とうる)(みち)(ゆき)(あきら)(なが)(あき)(とおる)(とおるふ)『カウ『キャウ
恒	{恆}恒。(コウ)〜(つね)(つねに)(のぶ)(ひさ)(ひさし)『ゴウ
恆	{恆}恒。(コウ)〜(つね・に)(わたる)(ひさし)『ゴウ『つね
桁	(コウ)〜(けた)『けた
横	{橫}横。(オウ)〜(よこ)『ワウ
横しま	よこしま
橫	{橫}横。オウ『よこ『ワウ
橫しま	よこしま
衡	(コウ)〜(ひら)『カウ『はかり『はかる
鵆	(ちどり)
軣	(コウ)〜(とどろ・かす)(とどろ・く)
薨	(コウ)〜(こう・じる)(みま・かる)
轟	(コウ)(ゴウ)〜(とどろ・かす)(とどろ・く)『ガウ『とどろ
弘	(コウ)(グ)〜(ひろ・い)(ひろ)(ひろし)(ひろむ)(みつ)(お)(こお)『ひろめる
宏	(コウ)〜(ひろ・い)(あつ)(ひろ)(ひろし)『クヮウ『ひろげる
泓	(オオ)(オウ)〜(ふか・い)
虹	(コウ)〜(にじ)『にじ
洪	(コウ)〜(ほん)
紅	(コウ)(ク)〜(べに)(くれない)(あか・い)(くれ)(もみ)『あか『グ『くれなゐ
紅絹	もみ
浤	(コウ)〜(ふか・い)
紘	(コウ)〜(おおづな)(つな)(つなぐ)(ひろ)(ひろし)『クヮウ
鴻	(コウ)〜(おおとり)(ひしくい)『おおがり『おほ『くひ
黌	(コウ)(オウ)
哄	(コウ)
訌	(コウ)
閧	(コウ)〜(とき)
鬨	(コウ)(グ)〜(とき)
侯	(コウ)
喉	(コウ)〜(のど)『こん『のみと『のんど
猴	(コウ)〜(さる)
篌	(ゴ)(コウ)
吽	(コウ)(ウン)(イン)(オン)(グ)〜(ほえ・る)
吼	(コウ)(ク)〜(ほ・える)
后	(コウ)(ゴ)〜(きさき)『きさい
厚	(コウ)〜(あつ・い)(あか)(あ)(あっ)
厚朴	ほお『ほほ
逅	(コウ)〜(あ・う)(まみ・える)
後	(ゴ)(コウ)〜(のち)(うし・ろ)(うしろ)(あと)(おく・れる)(こし)(し)(しい)(しり)『しりえ『へ『ゆり
後方	しりえ『へ
候	(コウ)〜(そうろう)『さう『さぶらう『そう『そろ
乎	(コ)(オ)〜(か)(ああ)(かな)(や)(よ)(を)
呼	(コ)〜(よ・ぶ)(よぶ)
忽	(コツ)〜(たちま・ち)(ゆるが・せ)(ぬ)
惚	(コツ)〜(ほけ・る)(ぼ・ける)(ほ・れる)
狐	(コ)〜(きつね)『きつ『けつね
弧	(コ)『ゆみ
胡	(ウ)(コ)(ゴ)〜(なんぞ)(えびす)(くる)
壷	(コ)〜(つぼ)
斛	(コク)〜(と)『さか
壺	(コ)〜(つぼ)
葫	(コ)『にんにく『ひる
湖	(コ)〜(みずうみ)(うみ)(み)『みづ
瑚	(コ)(ゴ)
楜	(コ)〜(くるみ)
槲	(コク)〜(かしわ)『かしは
蝴	(コ)
糊	(コ)(ゴ)(コツ)〜(のり)
醐	(ゴ)(コ)
餬	(コ)〜(かゆ)
鵠	(コク)(コウ)〜(くぐい)(まと)『くぐひ『こふ
虍	(コ)〜(とらかんむり)(とらがしら)
乕	(コ)〜(とら)
虎	(コ)〜(とら)(たけ)
虎魚	おこぜ『をこぜ
許	(キョ)〜(ゆる・す)(もと)『がり『ばかり
琥	(コ)
滸	(コ)〜(ほとり)
鯱	(しゃちほこ)(しゃち)『しゃっちょこ
戸	{戶}戸。(コ)〜(と)(え)(へ)(とびらのと)
互	(ゴ)〜(たが・い)(かたみ・に)
戶	{戶}戸。コ『と『へ
弖	(テ)
冴	(ゴ)(コ)〜(さ・える)(こお・る)(ひ・える)(さえ)(さえる)
冱	(ゴ)(コ)〜(さ・える)(こお・る)(ひ・える)
沍	(ゴ)(コ)〜(さ・える)(こお・る)(ひ・える)
怙	(コ)〜(たの・む)
笏	(コツ)〜(しゃく)
粐	(ロ)(コ)〜(よねど)
瓠	(コ)(カク)〜(ひさご)『ふくべ
扈	(コ)〜(したが・う)
滬	(コウ)(コ)
護	(ゴ)〜(まも・る)(もり)『まもり
花	(カ)(ケ)〜(はな)(わ)『クヮ
花弁	はなびら
花片	はなびら
埖	(ごみ)
椛	(かば)(もみじ)
硴	(かき)
糀	(こうじ)『かうぢ
錵	(カ)〜(にえ)
華	(カ)(ケ)〜(はな)(わ)『クヮ『クワ『ゲ
猾	(カツ)〜(わるがしこ・い)
滑	(カツ)(コツ)〜(すべ・る)(なめ・らか)(かり)(なめり)『クヮツ『ぬめ『ぬめる
嘩	{嘩}譁。(カ)(ケ)〜(かまびす・しい)『クヮ
磆	(カツ)
化	(カ)(ケ)〜(ば・ける)(ば・かす)(ふ・ける)(け・する)『クヮ
画	{畫}画。(ガ)(カク)(エ)(カイ)〜(えが・く)(かく・する)(かぎ・る)(はかりごと)(はか・る)『グヮ『クヮク『ヱ
崋	(カ)(ク)
畫	{畫}画。(ガ)(カク)(エ)(カイ)〜(えが・く)(かく・する)(かぎ・る)(はかりごと)(はか・る)『グヮ『クヮク『ヱ
話	(ワ)〜(はな・す)(はなし)
樺	{樺}枠。(カ)〜(かば)(かんば)(から)(かも)(かん)『かには『かにわ『わく
劃	(カク)〜(わ・かつ)(かぎ・る)『クヮク
徊	(カイ)(クワイ)(エ)〜(さまよ・う)
淮	(ワイ)(エ)(カイ)
槐	(カイ)〜(えんじゅ)(えんじ)『ゑんじゆ
踝	(カ)〜(くるぶし)『つぶなき
懐	{懷}懐。(カイ)(エ)〜(ふところ)(なつ・かしい)(なつ・かしむ)(なつ・く)(なつ・ける)(なず・ける)(いだ・く)(おも・う)(かね)『クヮイ『ほほ
懷	{懷}懐。(カイ)(エ)〜(ふところ)(なつ・かしい)(なつ・かしむ)(なつ・く)(なつ・ける)(いだ・く)(おも・う)『クヮイ『ほほ
坏	{壞}坏。(ハイ)〜(つき)(おか)『さかずき『づき
壊	〔壞〕壊。(カイ)(エ)〜(こわ・す)(こわ・れる)(やぶ・る)『クヮイ『ヱ
壞	{壞}坏。(カイ)(エ)〜(こわ・す)(こわ・れる)(やぶ・る)『クヮイ『さかずき『つき『づき『ヱ
歓	〔歡〕歓。(カン)〜(よろこ・ぶ)(ぶ)『クヮン
懽	(カン)〜(よろこ・ぶ)
歡	〔歡〕歓。(カン)〜(よろこ・ぶ)『クヮン
讙	(カン)(ケン)〜(かまびす・しい)
驩	(カン)〜(よろこ・ぶ)
桓	(カン)
圜	(カン)(エン)〜(まる・い)(めぐ・る)
寰	(カン)
環	(カン)〜(わ)(たま)(たまき)『クヮン『めぐる
鍰	からみ
鬟	(カン)〜(わげ)(みずら)『づら
緩	(カン)〜(ゆる・い)(ゆる・やか)(ゆる・む)(ゆる・める)(ひろ)『クヮン『ゆる
幻	(ゲン)〜(まぼろし)
奐	(カン)〜(あき・らか)
宦	(カン)〜(つかさ)
浣	(カン)〜(あら・う)『クヮン
患	(カン)〜(わずら・う)(くろ)『うれえる『クヮン『ゲン
換	(カン)〜(か・える)(か・える)(か・わる)『クヮン
喚	(カン)〜(わめ・く)『クヮン『よぶ
渙	(カン)〜(あきらか)(きよし)『クヮン
豢	(ケン)(カン)〜(やしな・う)
煥	(カン)〜(あきらか)
鯇	あめ『あめのうお『うを
肓	(コウ)
荒	(コウ)〜(あら・い)(あら)(あ・れる)(あ・らす)(あ・らし)(すさ・む)(ら)『クヮウ
荒城	あらき
慌	(コウ)〜(あわ・てる)(あわ・ただしい)『クヮウ
皇	(コウ)(オウ)〜(おうじ)(おお)(み)『きみ『クヮウ『すべ『すべら『すべらぎ『すめ『すめら『すめらぎ『ワウ
黄	{黃}黄。(コウ)(オウ)〜(き)(こ)(うい)(れい)『クヮウ『ワウ
黄櫨	{黃櫨}黄櫨。はじ『はぜ『はぜのき
黄鼬	{黃鼬}黄鼬。てん
凰	(オオ)(コウ)(オウ)〜(おおとり)
隍	(コウ)〜(ほり)『ほりき
黃	{黃}黄。オウ『き『クヮウ『こ『コウ『ワウ
黃櫨	{黃櫨}黄櫨。はじ『はぜ『はぜのき
黃鼬	{黃鼬}黄鼬。てん
遑	(カン)(コウ)〜(いとま)(ひま)
徨	(コウ)〜(さまよ・う)
湟	(コウ)
惶	(コウ)〜(おそ・れる)『クヮウ
煌	(コウ)〜(きらめ・く)(きら・めく)(かが・やく)
蝗	(コウ)〜(いなご)(ばった)
蝗虫	ばった
篁	(コウ)〜(たかむら)
簧	(コウ)〜(した)
鍠	(コウ)
鰉	(コウ)〜(ちょうざめ)(ひがい)
恍	(コウ)〜(とぼ・ける)(ほ・れる)『クワウ
晃	(コウ)〜(あきらか)(あき)(あきら)(てる)(ひかる)(みつ)『クヮウ
晄	(コウ)〜(あきらか)
幌	(コウ)〜(ほろ)(とばり)
滉	(コウ)〜(ひろ・い)『クヮウ
灰	(カイ)〜(はい)『クヮイ『はひ
恢	(カイ)(ケ)〜(ひろ・い)『クヮイ
揮	(キ)〜(ふる・う)
暉	(キ)〜(かが・やく)(てる)
詼	(カイ)〜(たわむれ)
輝	(キ)〜(かがや・く)(あき)(あきら)(さき)(てる)(ひ)(ひかる)
麾	(キ)〜(さしまね・く)(さしずばた)
徽	(キ)〜(しるし)
囘	(カイ)(エ)〜(まわ・る)(まわ・す)(もとお・る)(か・える)
回	(カイ)(エ)〜(まわ・る)(まわ・る)(まわ・り)(まわ・す)(まわ・す)(まわ・し)(まわ・し)(もとお・る)(か・える)『クヮイ『み『めぐる『わ『ヱ
回青橙	だいだい
廻	(カイ)(エ)〜(まわ・る)(まわ・す)(もとお・る)(めぐ・る)(めぐ・らす)(ざこ)(じゃく)『クヮイ『み『ヱ
茴	(ウイ)(カイ)
迴	(カイ)(エ)
蛔	(カイ)(ユウ)〜(かいちゅう)(はらのむし)
悔	〔悔〕悔。(カイ)〜(く・いる)(く・やむ)(くや・しい)『クヮイ『ケ
毀	(キ)〜(こぼ・つ)(こわ・す)(こぼ・れる)(こわ・れる)(そし・る)(やぶ・る)
燬	(キ)〜(や・く)
卉	(キ)(ケ)〜(くさ)
屶	(なた)(たな)
会	{會}会。(カイ)(エ)〜(あ・う)(あ・わせる)(あつ・まる)(あい)(い)『クヮイ『たまたま『ヱ
恚	(イ)〜(いか・る)
恵	〔惠〕恵。(ケイ)(エ)〜(めぐ・む)(めぐ・み)(あや)(け)(さと)(さとし)(しげ)(へい)(み)(やす)『ヱ
彗	(スイ)(エ)(ケイ)(セイ)〜(ほうき)(とし)
晦	(カイ)〜(つごもり)(くら・い)(みそか)(もり)『くらます『クヮイ『つきこもり『つもごり
晦日	つごもり『つもごり
惠	〔惠〕恵。(ケイ)(エ)〜(めぐ・む)(めぐ・み)『ヱ
喙	(カイ)〜(がい)(くちばし)
絵	〔繪〕絵。(カイ)(エ)『クヮイ『ヱ
匯	{匯}彙。(キ)(エ)(カイ)(ワイ)〜(がい)(めぐ・る)『イ『ヰ
賄	(ワイ)〜(まかな・う)『まいない『まいなう『まひなひ
會	{會}会。(カイ)(エ)〜(あ・う)(あ・わせる)(あつ・まる)(あい)『クヮイ『たまたま『ヱ
彙	{匯}彙。(イ)〜(はりねずみ)『ヰ
誨	(カイ)〜(おし・える)『クヮイ
慧	(ケイ)(エ)〜(さとい)(さと)(さとし)(さとる)(あきら)(とし)『ヱ
薈	(カイ)(ワイ)
諱	(キ)〜(いみな)(い・む)
檜	(カイ)〜(ひのき)(ひ)
穢	(アイ)(エ)(ワイ)〜(けが・す)(けが・れ)(けが・れる)『けがらわしい『ヱ
繪	〔繪〕絵。(カイ)(エ)『クヮイ『ヱ
昏	(コン)〜(くら・い)(くれ)
婚	(コン)
葷	(クン)
棔	(コン)〜(ねむのき)
混	(コン)〜(ま・じる)(ま・じり)(ま・ざる)(ま・ぜる)(こ・む)
渾	(コン)〜(すべ・て)(にご・る)
琿	(コン)
魂	(コン)〜(たましい)(たま)『だましい『たましひ『だましひ
溷	(コン)〜(かわや)(けが・れる)(にご・る)(みだ・れる)
諢	(コン)
豁	(カツ)〜(ひら・ける)(ひろ・い)『クヮツ
活	(カツ)〜(い・きる)(い・かす)(い・ける)『クヮツ
火	(カ)〜(ひ)(び)(ほ)『クヮ『コ
火糞	ほくそ
火焼	{火燒}火焼。ひたき
火燒	{火燒}火焼。ひたき
夥	(カ)(ワ)〜(おびただ・しい)
或	(ワク)(コク)(イキ)〜(あ・る)(あるい)(あるいは)『あるは
貨	(カ)『クヮ『たから
惑	(ワク)〜(まど・う)
禍	〔禍〕禍。(カ)〜(わざわい)『クヮ『はひ『まが
膕	(カク)(コク)(キョク)〜(ひかがみ)『よほろ
霍	(カク)〜(にわか)(つる)
獲	(カク)〜(え・る)『クヮク
穫	(カク)『クヮク
蠖	(ワク)(カク)
癨	(カク)
机	{機}机。(キ)〜(つくえ)『おしまずき『おしまづき『つき
肌	(キ)〜(はだ)『はだえ『へ
枅	(ケイ)〜(ひじき)
剞	(キ)〜(きざ・む)
笄	(ケイ)〜(こうがい)『かう
飢	(キ)〜(う・える)『え『ゑ
屐	(ゲキ)(ケキ)〜(はきもの)
基	(キ)〜(もと)(もとい)(きい)(とも)『ゐ
喞	(ショク)(ソク)〜(かこ・つ)
畸	(キ)
稘	(キ)
箕	(キ)〜(み)(みの)
撃	{擊}撃。(ゲキ)〜(う・つ)
稽	(ケイ)〜(かんが・える)(とど・める)『とどまる
緝	(シュウ)〜(つむ・ぐ)
畿	(キ)〜(みやこ)
機	{機}机。(キ)〜(はた)『おしまずき『おしまづき『つき『つくえ
積	(セキ)〜(つ・む)(づ・み)(つ・もる)(つ・もり)(か)(さか)(しゃこ)(ずみ)(つみ)
激	(ゲキ)〜(はげ・しい)
擊	{擊}撃。うつ『ゲキ
磯	(キ)〜(いそ)(し)(そ)
磯城	しき
雞	{雞}鶏。かけ『くたかけ『ケイ『とり『には『にわとり
雞冠	{雞冠}鶏冠。さか
鶏	{雞}鶏。(ケイ)〜(にわとり)(とり)『かけ『くたかけ『には
鶏冠	{雞冠}鶏冠。さか
譏	(キ)〜(そし・る)
韲	(セイ)(サイ)〜(あえもの)(な・ます)(あ・える)
饑	(キ)〜(う・える)
躋	(セイ)(サイ)〜(のぼ・る)
鷄	{雞}鷄。(ケイ)〜(にわとり)(とり)『かけ
癪	(しゃく)
齎	(セイ)(サイ)(シ)〜(もた・らす)
羇	(キ)(ハ)〜(おもが・い)(たづな)(たび)(つな・ぐ)
齏	(セイ)(サイ)〜(あえもの)(な・ます)(あ・える)
羈	(キ)(ハ)〜(おもが・い)(たづな)(たび)(つな・ぐ)『おもづら
覊	(キ)(ハ)〜(おもが・い)(たづな)(たび)(つな・ぐ)
及	(キュウ)〜(およ・ぶ)(およ・び)(および)(およ・ぼす)(おい)(の)『キフ
吉	(キチ)(キツ)〜(よし)(え)(き)(きっ)(きる)(こし)(と)(よ)『よい
岌	(キュウ)〜(たか・い)
汲	(キュウ)〜(く・む)(くみ)『キフ
即	〔卽〕即。(ソク)〜(つ・く)(つ・ける)(すなわ・ち)
佶	(キツ)(キチ)
亟	(キョク)(キ)(ケ)〜(しばしば)(すみやか)
笈	(キュウ)〜(おい)『おひ『キフ
卽	〔卽〕即。ソク
急	(キュウ)〜(いそ・ぐ)(いそ・ぎ)『キフ『せく
級	(キュウ)〜(しな)『キフ
疾	(シツ)『と『とし『はやい『やまい
極	(キョク)(ゴク)〜(きわ・める)(きわ・まる)(きわ・まり)(きわ・み)(き・める)(ぎ・め)(き・まる)『はたて
棘	(キョク)〜(いばら)(とげ)『おどろ
集	(シュウ)〜(あつ・まる)(あつ・める)(つど・う)(あつまり)(ず)『シフ
楫	{楫}檝。(シュウ)(ショウ)〜(かじ)(かい)『かぢ
嫉	(シツ)〜(そね・む)(ねた・む)(にく・む)『ねた
蕀	(キョク)
瘠	(セキ)(ジャク)〜(やせ・る)
檝	{楫}檝。かじ『かぢ
輯	(シュウ)〜(あつ・める)(やわ・らぐ)『シフ
藉	(シャ)(セキ)(ジャク)〜(かり・る)(ふ・む)『かす『しく
蹐	(セキ)
籍	(セキ)『ジャク
鶺	(セキ)
覿	(テキ)〜(あ・う)
几	(キ)〜(きにょう)(つくえ)『おしまずき『おしまづき
己	(コ)(キ)〜(おのれ)(つちのと)(し)(み)『うぬ『おどれ『おの『おら『おれ『な
脊	(セキ)〜(せ)(せい)
掎	(キ)〜(ひ・く)
戟	(ゲキ)〜(ほこ)
幾	(キ)〜(いく)(いく・つ)(いく・ら)(い)(く)『ほとほと
擠	(セイ)(サイ)〜(お・す)
彑	(ケイ)〜(けいがしら)
旡	(キ)(ケ)〜(む)(なし)(すでのつくり)
伎	(ギ)(キ)〜(わざ)(わざおぎ)
技	(ギ)〜(わざ)
芰	ひし
忌	(キ)〜(い・む)(い・み)(い・まわしい)(いまわ)『いもい『いもひ
忌（み）	いみ
妓	(ギ)(キ)〜(わざおぎ)(うたいめ)
季	(キ)〜(すえ)(とし)
計	(ケイ)〜(はか・る)(はか・らう)(え)(かず)(け)『はか『ばかり
迹	(セキ)(シャク)〜(あと)(ど)
既	〔既〕既。(キ)〜(すで・に)
紀	(キ)〜(おさむ)(ただす)(とし)(とも)(のり)(もと)『しるす
記	(キ)〜(しる・す)(のり)
剤	{劑}剤。(ザイ)(スイ)(セイ)〜(かる)(けず・る)
偈	(ゲ)(ケツ)(ケイ)〜(いこ・う)
祭	(サイ)〜(まつ・る)(まつ・り)(まつり)『まち
済	{濟}済。(サイ)(セイ)〜(す・む)(ず・み)(ずみ)(す・まない)(す・ます)(す・ます)(すく・う)(な・す)(わたし)(わた・る)(すむ)(なり)(わたる)
悸	(キ)『おそれる
寄	(キ)〜(よ・る)(よ・り)(よ・せる)(よせ)(より)(よろ)
寂	(ジャク)(セキ)〜(さび)(さび・しい)(さび・れる)(さみ・しい)
勣	(セキ)(シャク)〜(いさお)(つむ・ぐ)
跡	(セキ)〜(あと)『シャク『と
際	(サイ)〜(きわ)(ぎわ)(わ)『きは『ざい
継	{繼}継。(ケイ)〜(つ・ぐ)(まま)
禝	(ショク)〜(きび)
稷	(ショク)〜(きび)『きみ
髻	(ケイ)(キツ)〜(たぶさ)(みずら)(もとどり)『たきふさ『づら
薊	(ケイ)(キ)(カイ)(ケ)〜(あざみ)(さく)(とげ)
冀	(キ)〜(こいねが・う)(こいねが・わくは)
劑	{劑}剤。(ザイ)(スイ)(セイ)〜(かる)(けず・る)
覬	(キ)
濟	{濟}済。(サイ)(セイ)〜(す・む)(す・ます)(すく・う)(な・す)(わた・す)(わた・る)
績	(セキ)〜(み)『うむ『つむぐ
蹟	(セキ)(シャク)〜(あと)
繼	{繼}継。(ケイ)〜(つ・ぐ)(まま)
霽	(セイ)(サイ)〜(は・れる)(は・らす)
鰶	このしろ
驥	(キ)
加	(カ)〜(くわ・える)(くわ・わる)
佳	(カ)〜(けい)(よし)『よい
迦	(カ)(ケ)
珈	(カ)〜(かみかざり)
挟	〔挾〕挟。(キョウ)(ショウ)〜(はさ・む)(はさ・まる)(わきばさ・む)(さしはさ・む)『ケフ
枷	(カ)〜(かせ)(からざお)『かし
痂	(カ)(ケ)〜(かさ)(かさ・ぶた)『かせ
浹	(ショウ)〜(あまねし)
家	(カ)(ケ)〜(いえ)(や)(うち)(あり)(え)(く)(つか)(べ)『いへ『へ
家鴨	あひる
笳	(カ)〜(あしぶえ)
袈	(ケ)(カ)
葭	(カ)〜(よし)(あし)
跏	(カ)
筴	(キョウ)(サク)〜(めどぎ)
嘉	(カ)〜(よみ・する)(よい)(ひろ)(よし)(よしみ)(かず)(よ)
糘	(すくも)
夾	{夾}袷。(キョウ)(コウ)〜(はさ・む)『あはせ『あわせ『ケフ
莢	(キョウ)〜(さや)
戛	(カツ)〜(ほこ)
袷	{夾}袷。(コウ)(キョウ)〜(あわせ)『あはせ
戞	(カツ)〜(ほこ)
頬	{頰}頬。(キョウ)〜(ほお)(ほほ)『ケフ『つら『づら
鋏	(キョウ)〜(はさみ)(はさ・む)(つるぎ)『やっとこ
頰	{頰}頬。キョウ『ケフ『つら『づら『ほお『ほほ
甲	(コウ)(カン)(カ)〜(きのえ)(かぶと)(き)(まさ)(まさる)『カフ『かり『よろい『よろひ
甲斐	かい『かひ
岬	(コウ)〜(みさき)(さき)『カフ『みさき
胛	(コウ)〜(かいがらぼね)『かいがね
假	{假}仮。(カ)(ケ)〜(かり)(かり・る)
賈	(コ)(カ)〜(あきな・い)(あきな・う)(う・る)(か・う)『あきんど
榎	{檟}榎。(カ)〜(えのき)(え)(えの)
檟	{檟}榎。え『えのき
价	(カイ)
架	(カ)〜(か・ける)(か・かる)
嫁	(カ)〜(よめ)(とつ・ぐ)
稼	(カ)〜(かせ・ぐ)
價	{價}価。(カ)(ケ)〜(あたい)『あたひ
駕	(カ)(ガ)〜(かご)(が・する)(しのぐ)(のる)
駱	(ラク)〜(かわらげ)
幵	(ヘイ)
尖	(セン)〜(とが・る)(さき)(するど・い)
奸	{奸}姧。(カン)〜(おか・す)『かしましい『よこしま
戔	(セン)(サン)
肩	(ケン)〜(かた)
𧘱	ふき
姧	{奸}姧。かん
姦	{奸}姦。(カン)(ケン)〜(かん・する)(かしま・しい)(みだら)『よこしま
兼	(ケン)〜(か・ねる)(か・ねる)(かね)『かねて
菅	(カン)(ケン)〜(すげ)(す)(すが)(すご)
堅	(ケン)〜(かた・い)(がた・い)(きん)
堅魚	かつお『かつを
揃	(セン)〜(そろ・える)(そろ・う)(そろ・い)(き・る)
間	(カン)(ケン)〜(あいだ)(ま)(あい)『あはひ『あひ『あひだ『あわい『まん
間狭	{間狹}間狭。ませ
間狹	{間狹}間狭。ませ
牋	(セン)
蒹	(ケン)〜(おぎ)
煎	(セン)〜(せん・じる)(い・る)(に・る)(いり)
監	(カン)〜(けん)『げん
箋	(セン)〜(ふだ)
樫	(かし)
緘	(カン)〜(かん・する)(と・じる)
縑	かとり
艱	(カン)(ケン)〜(なや・む)(かた・い)(なやみ)
殱	(セン)〜(つく・す)(ほろぼ・す)
鰔	(カン)〜(かれい)(たら)
殲	(セン)〜(つく・す)(ほろぼ・す)
鰹	(ケン)〜(かつお)『かつを
柬	(カン)(ケン)〜(えら・ぶ)
倹	{儉}倹。(ケン)〜(つま・しい)(つづまやか)『つつましい
剪	(セン)〜(き・る)(つ・む)
剪刀	はさみ
揀	(カン)(ケン)〜(えら・ぶ)
検	〔檢〕検。(ケン)〜(しら・べる)
減	(ゲン)〜(へ・る)(へ・らす)
減り	めり
筧	(ケン)〜(かけひ)(かけい)『ひ
儉	{儉}倹。(ケン)〜(つま・しい)(つづまやか)『つつましい
翦	(セン)
檢	〔檢〕検。(ケン)〜(しら・べる)
蹇	(ケン)〜(いざ・る)(あしなえ)(なや・む)『なへ
謇	(ケン)〜(ども・る)
繭	(ケン)〜(まゆ)(きぬ)『まよ
瞼	(ケン)〜(まぶた)『まなぶた
簡	(カン)『えらぶ『ケン『てがみ『はぶく『ふだ『ふみた
鹸	{鹼}鹸。(ケン)(カン)(セン)〜(あ・く)
鹹	(カン)(ダイ)〜(から・い)(しおからい)(しおけ)(せいしゅ)
騫	(ケン)
鹼	{鹼}鹸。ケン
件	(ケン)〜(くだん)『くだり
見	(ケン)〜(み・る)(み・える)(み・せる)『あらわれる『ゲン『まみえる『み
建	(ケン)(コン)〜(た・てる)(た・て)(だ・て)(た・つ)(たけ)(たつ)(たて)『たける
荐	(セン)〜(しきりに)
栫	(セン)(ソン)
健	(ケン)〜(すこ・やか)(かつ)(たけ)(たけし)(たて)(とし)(やす)(やすし)
剣	{劍}剣。(ケン)〜(つるぎ)
釼	(ケン)〜(つるぎ)
剱	(ケン)〜(つるぎ)
践	〔踐〕践。(セン)〜(ふ・む)
腱	(ケン)(キン)
賎	(セン)(ゼン)〜(いや・しい)(いや・しむ)(いや・しめる)(しず)(やす・い)
僭	(シン)(セン)〜(せん・する)(おご・る)
漸	(ゼン)『やや『ようやく
墹	(まま)
賤	(セン)(ゼン)〜(いや・しい)(いや・しむ)(いや・しめる)(しず)(やす・い)『しづ
踐	〔踐〕践。(セン)〜(ふ・む)
箭	(セン)〜(や)『さ
劍	{劍}剣。(ケン)〜(つるぎ)
澗	(カン)(ケン)〜(たに)(たにみず)(ま)
薦	(セン)〜(すす・める)(こも)
鍵	(ケン)〜(かぎ)
劒	(ケン)〜(つるぎ)
劔	(ケン)〜(つるぎ)
餞	(セン)〜(はなむけ)『うまのはなむけ
諫	(カン)〜(いさ・める)
擶	(セン)〜(ただす)
濺	(セン)〜(そそ・ぐ)
繝	(カン)(ケン)
艦	(カン)
鑒	{鑒}鑑。(カン)〜(かんが・みる)(かがみ)
鑑	{鑒}鑑。(カン)〜(かんが・みる)(かがみ)(あき)(あきら)
江	(コウ)〜(え)(くん)(とうみ)(み)(りえ)『カウ『ガウ『かわ『ゴウ
将	{將}将。(ショウ)(ソウ)〜(まさ・に)(はた)(まさ)(ひきい・る)(もって)(かつ)(かつり)(すすむ)(たか)(ゆき)『シャウ『シヤウ
姜	(キョウ)(ガ)〜(こう)(かん)
將	{將}将。(ショウ)(ソウ)〜(まさ・に)(はた)(ひきい・る)(もって)(まさる)『シャウ『シヤウ
僵	(キョウ)〜(たお・れる)
漿	(ショウ)〜(こんず)『シャウ『シヤウ
薑	(キョウ)(コウ)〜(はじかみ)『シヤウ『しょうが
彊	(キョウ)(ゴウ)〜(つよ・い)(つよし)
橿	(キョウ)〜(かし)(もちのき)
疆	(キョウ)〜(さかい)『キャウ
蒋	(ショウ)(ソウ)〜(まこも)(はげ・ます)
奨	{獎}奨。(ショウ)(ソウ)〜(すす・める)(まさし)『シャウ
奬	{獎}奬。(ショウ)(ソウ)〜(すす・める)『シャウ
獎	{獎}奨。(ショウ)(ソウ)〜(すす・める)『シャウ
講	(コウ)『カウ
匠	(ショウ)〜(たくみ)『シャウ『シヤウ
杢	(モク)
降	(コウ)(ゴ)〜(お・りる)(お・ろす)(ふ・る)(ふ・り)(くだ・る)(くだ・す)(ふり)(ふる)『カウ『ガウ『ゴウ
絳	(コウ)〜(あか)
醤	{醬}醤。(ショウ)〜(ひしお)『しほ『シャウ『シヤウ
醬	{醬}醤。しほ『シャウ『シヤウ『ショウ『ひしお
交	(コウ)〜(まじ・わる)(まじ・える)(ま・じる)(まじ・る)(ま・ざる)(ま・ぜる)(か・う)(か・わす)(かわ・す)(こもごも)(かた)
交喙	いすか
交々	こもごも
郊	(コウ)『カウ
椒	(ショウ)〜(はじかみ)『セウ
蛟	(コウ)(キョウ)〜(みずち)『づ
焦	(ショウ)〜(こ・げる)(こ・がす)(こ・がれる)(あせ・る)『セウ
蕉	(ショウ)『セウ
膠	(コウ)(キョウ)〜(にかわ)(にべ)『カウ『かは『やに
澆	(ギョウ)〜(そそ・ぐ)
嬌	(キョウ)〜(なまめか・しい)『ケウ
礁	(ショウ)『セウ
鮫	(コウ)〜(さめ)(みずち)
驕	(キョウ)〜(おご・る)『おごり『ケウ
鷦	(ショウ)〜(さ)
嚼	(シャク)〜(か・む)
角	(カク)〜(かど)(つの)(い)(す)(すみ)(ずみ)(ふさ)
角髪	づら『みずら
角子	づら『みずら
佼	(キョウ)(コウ)〜(こう・す)(うつく・しい)
狡	(コウ)(キョウ)〜(ずる・い)(こす・い)(わるがしこ・い)『カウ『ずる
皎	(キョウ)(コウ)〜(きよ・い)(しろ・い)『カウ
脚	{腳}脚。(キャク)(キャ)(カク)〜(あし)(し)
絞	(コウ)〜(しぼ・る)(し・める)(し・まる)『カウ
腳	{腳}脚。あし『カク『キャṬ『キャク
剿	(ソウ)(ショウ)
勦	(ソウ)(ショウ)
僥	(ギョウ)(キョウ)
餃	(ギョウ)(キョウ)(コウ)
撹	(カク)(コウ)〜(みだ・す)
徼	(キョウ)(ヨウ)〜(めぐ・る)
矯	(キョウ)〜(た・める)『ケウ
鵤	(いかる)(いかるが)
纐	(コウ)〜(はな)
攪	(カク)(コウ)〜(みだ・す)『カウ
叫	(キョウ)〜(さけ・ぶ)『ケウ
教	(キョウ)〜(おし・える)(おそ・わる)(のり)(ひさ)『ケウ
窖	(コウ)(キョウ)〜(あなぐら)
較	(カク)(コウ)〜(くら・べる)『あきらか『カウ
酵	(コウ)『カウ『しらかす
轎	(キョウ)〜(かご)『ケウ
皆	(カイ)〜(みな)(みんな)(むな)
掲	{揭}掲。(ケイ)〜(かか・げる)
接	(セツ)(ショウ)〜(つ・ぐ)『セフ
秸	{秸}稭。しべ『みご
階	(カイ)〜(きざはし)(しな)(と)(はし)『きだはし
揭	{揭}掲。かかげる『ケイ
椄	(セツ)(ショウ)〜(つ・ぐ)
嗟	(サ)(シャ)〜(あ)(ああ)(なげ・く)
街	(ガイ)(カイ)〜(まち)(また)
稭	{秸}稭。しべ『みご
孑	(ケツ)〜(ひとり)
刧	(コウ)(ゴウ)(キョウ)〜(おびや・かす)
劫	(コウ)(ゴウ)(キョウ)〜(おびや・かす)『ケフ『コフ『ゴフ
劼	(カツ)(ケチ)
杰	(ケツ)(ゲチ)〜(すぐ・れる)
拮	(カツ)(ケツ)(キツ)〜(はた・らく)
桝	(ます)
桀	(ケツ)〜(ます)(はりつけ)
訐	(ケツ)〜(あば・く)
捷	(ショウ)(ソウ)〜(はや・い)(かつ)『セフ
傑	(ケツ)〜(すぐ)(たけ)(まさ)
結	(ケツ)(ケチ)〜(むす・ぶ)(ゆ・う)(ゆ・わえる)(ゆい)(ゆう)
結繒	ゆはた
睫	(ショウ)〜(まつげ)
節	〔節〕節。(セツ)(セチ)〜(ふし)(ぶし)(のっと)(たかし)『ふ『よ
詰	(キツ)(キチ)〜(つ・める)(つ・め)(づ・め)(つ・まる)(つ・む)(ずめ)(づめ)『なじる
截	(セツ)(サイ)〜(き・る)(たつ)
碣	(ケツ)〜(いしぶみ)
竭	(ケツ)〜(つく・す)
羯	(カツ)(ケツ)
潔	(ケツ)〜(いさぎよ・い)(きよ)(きよし)『きよい
姐	(ソ)(シャ)〜(あね)(ねえさん)
觧	(カイ)(ゲ)〜(と・く)(と・かす)(と・ける)(ほど・く)(ほど・ける)(わか・る)(さと・る)
解	(カイ)(ゲ)〜(と・く)(と・かす)(と・ける)(ほど・く)(ほど・ける)(わか・る)(さと・る)(さとる)(とけ)
檞	かしは『かしわ
介	(カイ)〜(すけ)(ゆき)『ケ
戒	(カイ)〜(いまし・める)
芥	(カイ)(ケ)〜(からし)(ごみ)(あくた)『ごもく
屆	〔屆〕届。(カイ)〜(とど・ける)(とど・く)『とどける
届	〔屆〕届。(カイ)〜(とど・ける)(とど・け)(とど・く)『とどける
界	{界}堺。(カイ)『さかい『さかひ
畍	(カイ)〜(さかい)
疥	(カイ)〜(はたけ)
借	(シャク)〜(か・りる)『シャ
堺	{界}堺。(カイ)〜(さかい)『さかひ
誡	(カイ)〜(いまし・める)『いましめ
曁	(キ)〜(およ・ぶ)
巾	(キン)(フク)〜(おお・い)(ちきり)(きれ)(はば)『べき
斤	(キン)〜(おの)
今	(コン)(キン)〜(いま)(な)『ま『むま
金	(キン)(コン)(ゴン)〜(かね)(かな)(がね)(かん)(きむ)(こ)(この)(ん)『こがね
金椀	{金碗}金椀。かなまり
金碗	{金碗}金椀。かなまり
津	(シン)〜(つ)(ず)(ち)(と)
衿	(キン)(コン)〜(えり)
矜	(キン)(キョウ)(ケイ)〜(あわ・れむ)(つつし・む)(ほこ・る)
筋	(キン)〜(すじ)『すぢ
襟	(キン)〜(えり)
堇	{堇}菫。すみれ
菫	{堇}菫。(キン)〜(すみれ)
僅	(キン)(ゴン)〜(わずか)
緊	(キン)
瑾	(キン)
槿	(キン)〜(むくげ)
儘	{盡}儘。(ジン)〜(まま)(ことごとく)『まんま
錦	(キン)〜(にしき)(かね)(あや)(にし)
謹	〔謹〕謹。(キン)〜(つつし・む)
饉	(キン)〜(う・える)
尽	{盡}尽。(ジン)(サン)〜(つ・くす)(つ・くす)(づ・くし)(つ・く)(づ・く)(ず・く)(つ・きる)(つ・かす)(さかづき)(ことごと・く)(つか)(つき)『ことごと『はたて
近	(キン)(コン)〜(ちか・い)(おう)(おお)(この)
侭	(ジン)〜(まま)(ことごとく)
勁	(ケイ)〜(つよ・い)
晋	{晉}晋。(シン)〜(すす・む)(すすむ)(ゆき)(くに)(すすみ)(のぶ)『すすむしん
晉	{晉}晋。(シン)〜(すす・む)『すすむしん
浸	(シン)〜(ひた・す)(ひた・る)
進	(シン)〜(すす・む)(すす・める)(のぶ)『じょう
禁	(キン)『いさめる
盡	{盡}儘。(ジン)(サン)〜(つ・くす)(つ・きる)(つ・かす)(さかづき)(ことごと・く)(まま)『ことごと『はたて
噤	(キン)〜(つぐ・む)
縉	(シン)〜(さしはさ・む)
壗	(まま)
覲	(キン)〜(まみ・える)
燼	(ジン)〜(もえのこり)『ぐひ『もえぐい
贐	(シン)〜(はなむけ)
茎	{莖}茎。(ケイ)(キョウ)〜(くき)
京	(キョウ)(ケイ)(キン)〜(みやこ)(たか)『キャウ『キヤウ
荊	(ケイ)〜(いばら)
荊棘	うばら『おどろ
亰	(キョウ)(ケイ)(キン)〜(みやこ)
莖	{莖}茎。(ケイ)(キョウ)〜(くき)
菁	(セイ)(ショウ)
旌	(セイ)(ショウ)〜(あら・わす)(はた)
経	{經}経。(ケイ)(キョウ)〜(へ・る)(た・つ)(たていと)(はか・る)(のり)(つね)(のぶ)『キャウ『キヤウ『キンṬ『たて『ふ
晶	(ショウ)〜(あ)(あき)(あきら)(ひかり)(まさ)『シャウ
睛	(セイ)(ショウ)〜(ひとみ)
粳	(コウ)〜(うるち)(ぬか)『うる
經	{經}経。(ケイ)(キョウ)〜(へ・る)(た・つ)(たていと)(はか・る)(のり)(つね)『キャウ『キヤウ『キンṬ『たて『ふ
兢	(キョウ)〜(おそ・れる)(つつ・しむ)
精	(セイ)(ショウ)(シヤウ)〜(きよ)『くわしい『シャウ『しらげる
橸	(まさ)
鯨	(ゲイ)〜(くじら)『いさな『くぢら
鯨波	とき
驚	(キョウ)〜(おどろ・く)(おどろ・かす)『キャウ
井	{井}丼。(セイ)(ショウ)〜(い)(いの)(さい)(ひ)『シャウ『どん『どんぶり『ゐ
井堰	いせき『ゐ
丼	{井}丼。(トン)(タン)(ショウ)(セイ)〜(どんぶり)『どん『どんぶり
剄	(ケイ)〜(くびき・る)
穽	(セイ)〜(おとしあな)
景	(ケイ)〜(かげ)『エイ
憬	(ケイ)〜(あこが・れる)
頸	(ケイ)〜(くび)
警	(ケイ)〜(いまし・める)『キャウ『キョウ
径	{徑}径。(ケイ)〜(みち)(こみち)(さしわたし)(ただちに)
浄	〔淨〕浄。(ジョウ)(セイ)〜(きよ・める)(きよ・い)『ジャウ
逕	(ケイ)〜(みち)(こみち)(さしわたし)(ただちに)
徑	{徑}径。(ケイ)〜(みち)(こみち)(さしわたし)(ただちに)
脛	(ケイ)〜(すね)(はぎ)
竟	(キョウ)(ケイ)〜(おわ・る)(ついに)(わた・る)『おえる『キャウ『つい『つひ
淨	{淨}瀞。(ジョウ)(セイ)〜(きよ・める)(きよ・い)『ジャウ『とろ
敬	(ケイ)(キョウ)〜(うやま・う)(け)(たか)(たかし)(たけ)(とし)(のり)(ひろ)(ゆき)(よし)『キャウ『つつしむ
痙	(ケイ)〜(つ・る)(ひきつ・る)
靖	(セイ)(ジョウ)〜(やす・んじる)(のぶ)(やす)(やすし)(しず)(おさむ)(きよし)『やすい『やすんずる
静	{靜}静。(セイ)(ジョウ)〜(しず)(しず・か)(しず・まる)(しず・める)(しづ)『ジャウ
境	(キョウ)(ケイ)〜(さかい)(さか)(じき)『キャウ『キヤウ『さかひ
頚	(ケイ)〜(くび)
靜	{靜}静。(セイ)(ジョウ)〜(しず)(しず・か)(しず・まる)(しず・める)(しずか)『しづ『ジャウ
瀞	{淨}瀞。(セイ)(ショウ)(ジュウ)〜(とろ)(きよ・い)
鏡	(キョウ)(ケイ)〜(かがみ)(あき)(かが)(かがん)『キャウ
競	(キョウ)(ケイ)〜(きそ・う)(せ・る)(かい)(わたなべ)『キャウ『くら『くらべる
竸	(キョウ)(ケイ)〜(きそ・う)(せ・る)(くら・べる)
冏	(ケイ)(キョウ)(ソウ)〜(あきらか)
迥	(ケイ)(ギョウ)〜(はるか)
炯	(ケイ)(キョウ)〜(あきらか)(かま)
烱	(ケイ)(キョウ)〜(あきらか)
絅	(ケイ)〜(ひ・く)
窘	(キン)〜(たしな・める)(くるし・む)
究	(キュウ)(ク)〜(きわ・める)(きゅ)『キウ
糺	(キュウ)〜(ただ・す)(あざな・う)
糾	(キュウ)〜(ただ・す)『あざなう『キウ
赳	(キュウ)〜(たけ)(たけし)『キウ
啾	(シュウ)〜(な・く)
鳩	(キュウ)(ク)〜(はと)(あつ・める)(やす)『キウ
摎	(ク)(キュウ)
樛	(キュウ)〜(つが)
鬮	(キュウ)〜(くじ)
九	(キュウ)(ク)〜(ここの)(ここの・つ)(いちじく)(いちのく)(この)(ひさし)『キウ『ここ『チュー
久	(キュウ)(ク)〜(ひさ・しい)(きゅ)(わ)『キウ『ひさ
玖	(キュウ)(ク)〜(たま)(き)(ひさ)『キウ
灸	(キュウ)(ク)〜(やいと)『キウ
韭	{韭}韮。(キュウ)(ク)〜(にら)『かみら『みら
酒	(シュ)〜(さけ)(さか)(き)(さ)(し)『くし『ささ
韮	{韭}韮。(キュウ)(ク)〜(にら)『かみら『みら
旧	{舊}旧。(キュウ)〜(ふる・い)(もと)『キウ『ク『ふる
臼	(キュウ)(グ)〜(うす)(うすづ・く)『キウ
咎	(キュウ)(コウ)〜(とが・める)(とが)『キウ
疚	(キュウ)〜(やま・しい)(や・む)
柾	{柩}柾。(まさ)(まさめ)(まさき)
柩	{柩}柾。(キュウ)(グ)〜(ひちぎ)(ひつぎ)『キウ『まさ
救	(キュウ)〜(すく・う)『キウ『ク
厩	{廄}厩。(キュウ)〜(うまや)(まや)(まら)『キウ
就	(シュウ)(ジュ)〜(つ・く)(つ・ける)(たか)(なり)『シウ『なす『なる
廐	(キュウ)〜(うまや)
廄	{廄}厩。うまや『キウ『キュウ
舅	(キュウ)〜(しゅうと)『キウ『しうと
廏	(キュウ)〜(うまや)
舊	{舊}旧。(キュウ)〜(ふる・い)(もと)『キウ『ク『ふる
鷲	(シュウ)(ジュ)〜(す)(わ)(わせ)『わし
圧	{壓}圧。(アツ)(エン)(オウ)〜(お・す)(へ・す)(おさ・える)(お・さえる)
拘	(コウ)〜(かか・わる)『とらえる
苴	(ソ)(サ)(シャ)(ショ)〜(つと)(あさ)
狙	(ソ)(ショ)〜(ねら・う)(ねら・い)
居	(キョ)(コ)〜(い・る)(い)(お・る)(おき)(ぐ)(すえ)『う『おく『ゐ
俥	(くるま)
砠	(ソ)(ショ)
疽	(ソ)(ショ)〜(かさ)
掬	(キク)(コク)〜(きく・す)(むす・ぶ)(すく・う)(たなごころ)
娵	(シュ)(シュウ)(ス)(ソウ)〜(よめ)
椐	へみ
雎	(ショ)
雎鳩	みさご
裾	(キョ)(コ)〜(すそ)『すそ
駒	(ク)〜(こま)『こま
鞠	(キク)(キュウ)〜(まり)(まい)
鞫	(キク)
局	{局}跼。(キョク)〜(つぼね)
桔	(キツ)(ケツ)〜(き)
菊	(キク)
椈	(キク)『ぶな
跼	{局}跼。(キョク)〜(こご・む)(くぐま・る)(かが・む)(せぐく・まる)
橘	(キツ)〜(たちばな)(きっ)
鵙	(ケキ)(ゲキ)〜(もず)
咀	(ソ)(ショ)〜(か・む)
沮	(ソ)(ショ)〜(はば・む)
矩	(ク)〜(かね)(かねざし)(さしがね)(のり)(つね)(ただし)
挙	{舉}挙。(キョ)〜(あ・げる)(あ・がる)(こぞ・る)(たか)
筥	(キョ)〜(はこ)
蒟	(コン)(ク)
舉	{舉}挙。(キョ)〜(あ・げる)(あ・がる)(こぞ・る)
擧	{舉}擧。(キョ)〜(あ・げる)(あ・がる)(こぞ・る)
櫸	{櫸}欅。けやき
齟	(ソ)(サ)(ショ)〜(かむ)
欅	{櫸}欅。(キョ)〜(けやき)
襷	(たすき)
巨	(キョ)〜(おお)(か)(こ)(なお)『おおい『おおきい
句	(ク)〜(すく)
拒	(キョ)(ゴ)〜(こば・む)『ふせぐ
苣	(キョ)〜(ちしゃ)
拠	{據}拠。(キョ)(コ)〜(よ・る)『よりどころ
拠り所	よりどころ
具	(グ)〜(そな・える)(つぶさ・に)(とも)『そなわる『よろい『よろひ
炬	(コ)(キョ)〜(たい)『たいまつ
秬	(キョ)〜(くろきび)
俱	{俱}倶。ク『グ『ともに
倶	{俱}倶。(グ)(ク)〜(とも・に)
倨	(キョ)(コ)〜(おご・る)
粔籹	おこし
据	{據}据。(キョ)〜(す・える)(す・わる)『すえる
距	(キョ)〜(へだ・たる)『けづめ『へだてる
惧	{懼}惧。(ク)〜(おそ・れる)『グ
鉅	(キョ)〜(はがね)
聚	(シュウ)(シュ)〜(あつ・まる)『あつめる『ジュ
劇	(ゲキ)『はげしい
踞	(キョ)(コ)〜(うずく・まる)
據	{據}拠。(キョ)(コ)〜(よ・る)『すえる『すわる『よりどころ
據り所	よりどころ
遽	(キョ)〜(あわ・てる)(あわただ・しい)(すみやか)(にわか)
鋸	(キョ)(コ)〜(のこ)(のこぎり)
窶	(ロウ)(ク)(ル)〜(や・つる)(や・つれる)
颶	(グ)(ク)
醵	(キョ)
懼	{懼}惧。(ク)〜(おそ・れる)『グ
捐	(エン)〜(す・てる)
涓	(ケン)
娟	(エン)(ケン)
鵑	(ケン)
鐫	(セン)〜(ほ・る)(え・る)(き・る)(のみ)
呟	(ゲン)〜(つぶや・く)
卷	{卷}巻。(カン)(ケン)〜(ま・く)(まき)『クヮン『クワン『まくる
巻	{卷}巻。(カン)(ケン)〜(ま・く)(まき)(ま・き)『クヮン『クワン
捲	{卷}捲。(ケン)〜(ま・く)(ま・くる)(まく・る)(めく・る)(まく・れる)
劵	(ケン)〜(てがた)(わりふ)
倦	(ケン)〜(あき・る)(あぐ・む)(あぐ・ねる)(う・む)(つか・れる)『うんずる
狷	(ケン)
悁	(エン)(ケン)
眷	(ケン)〜(かえり・みる)
雋	(シュン)(セン)〜(すぐ・れる)
絹	(ケン)〜(きぬ)
羂	(ケン)〜(わな)
亅	(ケツ)〜(かぎ)(はねぼう)
夬	(カイ)(ケツ)(ケチ)〜(わ・ける)
决	(ケチ)(ケツ)〜(き・める)(き・まる)(さ・く)
刔	(ケツ)〜(えぐ・る)
抉	(ケツ)〜(えぐ・る)(こじ・る)(くじ・る)
決	(ケツ)〜(き・める)(ぎ・め)(き・まる)(さ・く)『ケチ
玦	けつ
掘	(クツ)〜(ほ・る)(ぼり)
桷	(カク)〜(たるき)『ずみ
崛	(クツ)〜(そばだ・つ)(たか・い)
訣	(ケツ)〜(わかれ)(わかれ・る)
厥	(ケツ)(クツ)〜(その)(それ)
覚	{覺}覚。(カク)〜(おぼ・える)(さ・ます)(さ・める)(さと・る)
絶	{絕}絶。(ゼツ)〜(た・える)(た・やす)(た・つ)
絕	{絕}絶。ゼツ『たえる『たつ『たやす
蕨	(ケツ)〜(わらび)『わら
鴃	(ケイ)(ケキ)(ケツ)〜(もず)
獗	(ケツ)
爵	(シャク)
蹶	(ケツ)(ケイ)〜(たお・れる)(つまず・く)
譎	(ケツ)(キツ)〜(いつわ・る)(いつわ・り)
矍	(カク)
覺	{覺}覚。(カク)〜(おぼ・える)(さ・ます)(さ・める)(さと・る)(がく)
攫	(カク)〜(さら・う)(つか・む)
钁	(カク)(キャク)
倔	(クツ)〜(つよ・い)
均	(キン)〜(なら・す)(ひとし)『ひとしい
君	(クン)〜(きみ)(ぎみ)(み)
軍	(グン)『いくさ
菌	(キン)『きのこ『くさびら
桾	(クン)
鈞	(キン)〜(ひと・しい)
皸	{皸}皹。(クン)(キン)〜(ひび)(あかぎれ)『あかがり
皹	{皸}皹。(クン)(キン)〜(ひび)(あかぎれ)『あかがり
麇	{麇}麕。のろ
麕	{麇}麕。(キン)(クン)〜(のろ)
俊	(シュン)〜(すぐる)(とし)
郡	(グン)〜(こうり)『こおり『こほり
峻	(シュン)〜(けわ・しい)(たか・い)(たか)(たかし)(ちか)(とし)(おか)
浚	(シュン)〜(さら・える)(さら・う)
竣	(ドウ)(シュン)〜(わらわ)(わらべ)(おわ・る)
箟	(キン)
箘	(キン)
儁	(シュン)〜(すぐ・れる)
駿	(シュン)(スン)〜(すぐ・れる)(する)(とし)(はやし)(はやお)
哢	(ロウ)〜(さえず・る)
喀	(カク)〜(は・く)
卡	{卡}峠。たうげ『とうげ
垰	(たわ)(とうげ)(たお)(あくつ)
裃	(かみしも)
揩	(カイ)(カツ)〜(ぬぐ・う)
開	(カイ)〜(ひら・く)(ひら・き)(びら・き)(ひら・ける)(あ・く)(あ・ける)(はる)(か)
剴	(ガイ)(カイ)
凱	(ガイ)(カイ)〜(かちどき)(やわらぐ)
慨	〔慨〕慨。(ガイ)
楷	(カイ)
鎧	(カイ)(ガイ)〜(よろ・う)(よろい)『よろひ
愾	(ガイ)(キ)(ケ)(キツ)〜(ためいき)
刊	(カン)
栞	(カン)〜(しおり)
勘	(カン)〜(か)(さとる)『かんがえる
堪	(カン)(タン)〜(た・える)(たま・る)(こ・らえる)(こた・える)
戡	(カン)(チン)〜(かつ)(さす)
龕	(カン)(ガン)〜(れい)
坎	(カン)〜(あな)
侃	(カン)〜(つよ・い)(あきら)(ただし)
檻	(カン)〜(おり)(おばしま)(てすり)『をり
轗	(カン)(コン)
看	(カン)〜(み・る)
瞰	(カン)〜(み・る)
康	(コウ)〜(かん)(こ)(みち)(やす)(やすし)『カウ『やすい『やすらか
慷	(コウ)
糠	(コウ)〜(ぬか)『カウ
鱇	(コウ)
扛	(コウ)〜(あ・げる)
亢	(コウ)〜(たかぶる)『カウ
伉	(コウ)〜(たぐ・い)(なら・ぶ)
抗	(コウ)『カウ
尻	(コウ)〜(しり)(がみ)『けつ『しり
尻繋	しりがい
考	{考}攷。(コウ)〜(かんが・える)(かんが・え)(たか)『カウ
攷	{考}攷。(コウ)〜(かんが・える)『カウ
拷	(ゴウ)『ガウ
𣑥	たえ『たへ
栲	(コウ)〜(かえ)(たえ)『たく『たへ
犒	(コウ)〜(ねぎら・う)
靠	(コウ)〜(もた・れる)(たが・う)(よ・る)
苛	(カ)〜(いじ・める)(さいな・む)(いらだ・つ)(からい)(こまかい)『いら
珂	(カ)〜(が)
柯	(カ)〜(え)『ふる
科	(カ)〜(しな)『クヮ『クワ『しぐさ『とが
萪	(カ)
軻	(カ)
痾	(ア)〜(やまい)
窠	か『クワ
蝌	(カ)
顆	(カ・)〜(つ・ぶ・)『クヮ
咳	(カイ)(ガイ)〜(せ・く)(しわぶ・く)(せき)(しわぶき)
殻	{殼}殻。(カク)(コク)(バイ)〜(から)(がら)『かい『かひ
可	(カ)(コク)〜(べ・き)(べ・し)(よし)『よい
可惜	あたら『あったら
可祝	かしく
渇	{渴}渇。(カツ)〜(かわ・く)『カチ
渴	{渴}渇。カチ『カツ『かわく
克	(コク)〜(か・つ)(かつ)(まさる)(よし)『よく
刻	(コク)〜(きざ・む)(きざ・み)『きざ
剋	(コク)〜(かつ)
峇	(コウ)
恪	(カク)〜(つつし・む)
客	(キャク)(カク)『まらうど『まらひと『まれびと『まろうど
客人	まらうど『まれびと『まろうど
尅	(コク)〜(かつ)
溘	(コウ)
課	(カ)『クヮ『クワ
肯	(コウ)〜(がえんじ・る)『うけがう『がえんずる
墾	(コン)
懇	(コン)〜(ねんご・ろ)
坑	(コウ)『あな『カウ
吭	(コウ)〜(のど)
鏗	(コウ)〜(つく)
空	(クウ)〜(そら)(あ・く)(あ・き)(あ・ける)(から)(す・く)(す・かす)(むな・しい)(うつ)(き)(く)『うつお『うつせ『うつほ『うつろ『うろ『むな
空穂	{空穗}空穂。うつお『うつほ
空穗	{空穗}空穂。うつお『うつほ
倥	(コウ)〜(ぬか・る)
箜	(ク)(コウ)
鵼	ぬえ
孔	(コウ)〜(あな)(のり)『ク
恐	(キョウ)〜(おそ・れる)(おそ・る)(おそ・ろしい)(こわ・い)(こわ・がる)『かしく『かしこ『こは『こわ
恐れ	おそれ
控	(コウ)〜(ひか・える)(ひか・え)
口	(コウ)(ク)〜(くち)
叩	(コウ)〜(たた・く)(はた・く)(すぎ)
扣	{扣}釦。(コウ)〜(たた・く)(ひか・える)『ボタン
怐	(ク)
冦	(コウ)〜(あだ・する)
釦	{扣}釦。(コウ)(ク)〜(ぼたん)
寇	(コウ)〜(あだ・する)『あた『あだ
刳	(コ)〜(く・る)(えぐ・る)
枯	(コ)〜(か・れる)(か・らす)
桍	(コ)
哭	(コク)〜(なげ・く)(な・く)『ね
堀	(クツ)〜(ほり)(ほっ)『ほり
窟	(クツ)(コツ)〜(いわや)(いはや)(あな)
苦	(ク)〜(くる・しい)(ぐる・しい)(くる・しむ)(くる・しめる)(にが・い)(にが・る)『にが
庫	(コ)(ク)〜(くら)
袴	{褲}袴。(コ)(ク)〜(はかま)(ずぼん)『パジ『バチ
酷	(コク)〜(ひど・い)『むごい
褲	{褲}袴。こ『はかま『パジ『バチ
夸	(コ)(カ)〜(ほご・る)
誇	(コ)〜(ほこ・る)
銙	か『クワ
胯	(コウ)(カ)(コ)〜(また)
跨	(コ)(カ)〜(また・がる)(またが・る)(また・ぐ)『また
圦	(イリ)
快	(カイ)〜(こころよ・い)(よし)『クヮイ『クワイ『ケ
塊	(カイ)(ケ)〜(かたまり)(つちくれ)『くれ『クヮイ『ほど『まるかし『まるかせ『まろかし『まろかせ
塊芋	ほど
獪	(カイ)〜(わるがしこ・い)『クヮイ
膾	(カイ)(ケ)〜(なま・す)
鱠	(カイ)(ケ)〜(えそ)(なます)
寛	{寬}寛。(カン)〜(くつろ・ぐ)(ひろ・い)(ゆる・やか)(とも)(のぶ)(のり)(ひろし)(ひろん)(ゆた)(ゆたか)『クヮン『クワン
寬	{寬}寛。カン『くつろぐ『クヮン『クワン『ひろい『ゆた『ゆるやか
款	(カン)〜(まさ)『クヮン『クワン
款冬	ふき
匡	(キョウ)(オウ)〜(すく・う)(ただ)(ただし)(ただす)(まさ)(まさし)(きよ)(ひと)(やす)『キャウ
筐	(キョウ)〜(かたみ)(かご)(はこ)
筺	(キョウ)〜(かたみ)(かご)(はこ)(こばこ)
抂	(キョウ)(ゴウ)
狂	(キョウ)〜(くる・う)(くる・おしい)(くるお・しい)『キャウ『キヤウ
誑	(キョウ)〜(たばか・る)(たぶら・かす)(た・らす)
况	(キョウ)〜(まし・て)(いわ・んや)(おもむき)
況	(キョウ)〜(まし・て)(いわ・んや)(おもむき)『キャウ
昿	(コウ)〜(あきらか)(むな・しい)
框	(キョウ)〜(かまち)『わく
砿	(コウ)〜(あらがね)
眶	まかぶら『まなかぶら
絋	(コウ)
絖	(コウ)〜(ぬめ)(わた)
鉱	{礦}鉱。(コウ)〜(あらがね)『クヮウ
壙	(コウ)〜(あな)
曠	(コウ)〜(あきらか)(むな・しい)『クヮウ
礦	{礦}鉱。(コウ)〜(あらがね)『クヮウ
鑛	{礦}鑛。(コウ)〜(あらがね)『クヮウ
窺	(キ)〜(うかが・う)(のぞく)
虧	(キ)〜(か・ける)
奎	(ケイ)(キ)
逵	(キ)〜(おおじ)
馗	(キ)
揆	(キ)〜(はかりごと)(はか・る)
葵	(キ)〜(あおい)(まもる)(け)『あふひ
魁	(カイ)〜(さきがけ)(かしら)『クヮイ『クワイ
傀	(カイ)〜(おおき・い)
喟	(キ)(カイ)〜(なげ・く)
愧	(キ)〜(はじ・る)(はじ・らう)(はずかし・める)(とが・める)『はじ
匱	(キ)〜(ひつ)
潰	(カイ)(エ)〜(つぶ・す)(つぶ・れる)(つい・える)『クヮイ
餽	(キ)〜(おく・る)
簣	(キ)〜(もっこ)(あじか)
饋	(キ)〜(おく・る)
坤	(コン)〜(つち)(ひつじさる)
昆	(コン)
菎	(コン)
崑	(コン)
焜	(コン)〜(かが・やく)
褌	(コン)〜(ふんどし)『たふさぎ『とうさぎ『ふどし『へこ『みつ
鯤	(コン)
鶤	(ウン)(コン)〜(とうまる)(しゃも)
捆	{捆}梱。カウ『こうり『こり『コン『しきみ
悃	(コン)〜(まごころ)
梱	{捆}梱。(コン)〜(こう・る)(こうり)(こり)(しきみ)『カウ
壼	(コン)
困	(コン)〜(こま・る)
拡	〔擴〕拡。(カク)(コウ)〜(ひろ・がる)(ひろ・げる)(ひろ・める)『クヮク
括	(カツ)〜(くく・る)『くびれる『クヮツ
蛞	(カツ)
筈	(カツ)〜(はず)(やはず)
廓	(カク)〜(くるわ)(とりで)『クヮク『クワク
擴	〔擴〕拡。(カク)(コウ)〜(ひろ・がる)(ひろ・げる)(ひろ・める)『クヮク
闊	(カツ)〜(ひろ・い)『クヮツ
濶	(カツ)〜(ひろ・い)
拉	(ラツ)(ラ)(ロウ)〜(らっ・する)(ひし・ぐ)(くだ・く)
柆	(ロウ)
剌	(ラツ)〜(もと・る)
喇	(ラツ)(ラ)
腊	{臘}腊。きたい『きたひ
溂	(ラツ)
蝋	{蠟}蝋。(ロウ)〜(みつろう)(ろうそく)(あじ)『ラフ
辣	(ラツ)〜(から・い)
辣韭	{辣韭}辣韮。らっきょう
辣韮	{辣韭}辣韮。らっきょう
臘	{臘}腊。(ロウ)『きたい『きたひ『ラフ
蠟	{蠟}蝋。ラフ『ロウ
鑞	(ロウ)『ラフ
来	{來}来。(ライ)(タイ)〜(く・る)(きた・る)(きた・す)(き・たす)(き・たる)(き)(こ)(くり)(くる)(ごろ)(さ)『く『け
來	{來}来。(ライ)(タイ)〜(く・る)(きた・る)(きた・す)(き・たす)(き・たる)『く『け『こ
莱	(ライ)(リ)〜(あかざ)(あわち)(こうがい)
徠	(ライ)〜(きた・す)(きた・る)(く・る)
賚	(ライ)〜(たま・う)(たまもの)
頼	{賴}頼。(ライ)〜(たの・む)(たの・もしい)(たよ・る)(よち)(より)
賴	{賴}頼。たのむ『たのもしい『たよる『ライ
藾	(ライ)
瀬	{瀨}瀬。(ライ)〜(せ)(いわた)(がせ)(しげ)(せい)(せっ)『せ
瀨	{瀨}瀬。せ『ライ
癩	(ライ)『かったい『ゐ
籟	(ライ)〜(ふえ)
婪	(ラン)〜(むさぼ・る)
嵐	(ラン)〜(あらし)(ぞれ)
儖	(ラン)
藍	(ラン)〜(あい)『あゐ
闌	(ラン)〜(た・ける)(たけなわ)(てすり)『おばしま『たけなは
襤	(ラン)〜(ぼろ)
蘭	(ラン)(ラ)〜(か)(あららぎ)『らに
籃	(ラン)〜(かご)
瀾	(ラン)〜(なみ)
繿	(ラン)〜(ぼろ)
欄	〔欄〕欄。(ラン)〜(てすり)『おばしま
欄	〔欄〕欄。ラン
襴	(ラン)(リン)
醂	(ラン)(リン)〜(あわ・す)(さわ・す)
覧	〔覽〕覧。(ラン)〜(み・る)
懶	(ラン)(ライ)〜(ものうい)(おこたる)
嬾	(ラン)〜(おこた・る)(ものうい)
覽	〔覽〕覧。(ラン)〜(み・る)
攬	(ラン)〜(と・る)
欖	(ラン)
纜	(ラン)〜(ともづな)
燗	{爛}燗。(ラン)(カン)〜(かん・する)
濫	(ラン)〜(みだ・りに)(みだ・りがましい)『みだり
爛	{爛}燗。(ラン)〜(ただ・れる)『かん
郎	〔郞〕郎。(ロウ)(リョウ)〜(おとこ)(いら)(お)(とう)(もん)(ろ)(ろお)『おのこ『ラウ
郞	〔郞〕郎。ロウ
狼	(ロウ)〜(おおかみ)『おおかめ『おほ『ラウ
琅	(ロウ)
廊	〔廊〕廊。(ロウ)『ラウ
廊	〔廊〕廊。ロウ
瑯	(ロウ)
榔	(ロウ)
螂	(ロウ)
朗	〔朗〕朗。(ロウ)〜(ほが・らか)(あき・らか)(あき)(あきら)(お)(さえ)(ろ)
朗	〔朗〕朗。ほがらか
朗	〔朗〕朗。ラウ
朗	〔朗〕朗。ロウ
朖	(ロウ)〜(ほが・らか)(あき・らか)
浪	(ロウ)〜(なに)(なみ)『ラウ
撈	(ロウ)(リョウ)
労	{勞}労。(ロウ)〜(ろう・する)(いたわ・る)(いた・ずき)(ねぎら)(つか・れる)(ねぎら・う)『ラウ
労き	いたずき『いたつき『いたづき
牢	(ロウ)〜(かた・い)(ひとや)『ラウ
勞	{勞}労。(ロウ)〜(ろう・する)(いたわ・る)(いた・ずき)(ねぎら・う)(つか・れる)(ねぎら・い)『ラウ
勞き	いたずき『いたつき『いたづき
癆	(ロウ)
醪	(ロウ)〜(もろみ)(にごりざけ)『もそろ
老	(ロウ)〜(お・いる)(ふ・ける)(えび)(おい)(び)『ラウ
老成	ひね
咾	(ロウ)
姥	(ボ)(モ)〜(うば)『むば
蛯	(ケン)〜(えび)
烙	(ラク)(カク)〜(や・く)『ロク
酪	(ラク)
仂	(ドウ)(リュク)(リキ)(ロク)(リョク)〜(はたら・く)
勒	(ロク)〜(くつわ)
了	(リョウ)〜(さとる)『おえる『おわる『レウ
雷	(ライ)〜(かみなり)(いかずち)『いかづち
雷魚	はたはた
縲	(ルイ)
櫑	(ライ)〜(さか・だる)
羸	(ルイ)〜(つか・れる)(よわ・い)
罍	(ライ)〜(さかだる)
鱩	はたはた
欙	かんじき
耒	(ライ)(ルイ)〜(き)(く)(すき)(らいすき)
塁	{壘}塁。(ルイ)(ライ)(スイ)〜(とりで)(る)
誄	(ルイ)〜(しのびごと)
樏	かんじき『わりご
磊	(ライ)
蕾	(ライ)〜(つぼみ)
儡	(ライ)
壘	{壘}塁。(ルイ)(ライ)(スイ)〜(とりで)
肋	(ロク)〜(あばら)『ばら
泪	{淚}泪。(ルイ)(レイ)〜(なみだ)
涙	{淚}涙。(ルイ)(レイ)〜(なみだ)『なだ『なんだ
累	(ルイ)『かさね
淚	{淚}泪。なだ『なみだ『なんだ『ルイ
擂	(ライ)〜(す・る)
錑	もじ『もぢ
類	〔類〕類。(ルイ)〜(たぐ・い)
類	〔類〕類。たぐい『ルイ
棱	{棱}稜。かど『そば『リョウ
棱威	{棱威}稜威。いつ
楞	(リョウ)(ロウ)〜(かど)
稜	{棱}稜。(リョウ)(ロウ)〜(いつ)(かど)『そば
稜威	{棱威}稜威。いつ
薐	(ロウ)〜(ほうれんそう)
冷	(レイ)〜(つめ・たい)(ひ・える)(ひ・や)(ひ・ややか)(ひ・やす)(ひ・やかす)(さ・める)(さ・ます)
厘	(リン)
狸	{狸}貍。(リ)(ライ)〜(たぬき)
梨	(リ)〜(なし)(か)『なし
梨子	なし
犁	{犁}犂。(リ)(レイ)(リュウ)〜(すき)『からすき
犂	{犁}犂。(リ)(レイ)(リュウ)〜(すき)『からすき
甅	(センチグラム)
蜊	(リ)〜(あさり)
漓	(リ)〜(うす・い)
璃	(リ)〜(あき)
貍	{狸}貍。(リ)(ライ)〜(たぬき)
竰	(センチリットル)
黎	(レイ)(リ)〜(くろ・い)(れ)
糎	(センチメートル)〜(せんち)
罹	(リ)(ラ)〜(かか・る)
醨	しる『もそろ
釐	(リ)〜(おさ・める)(さいわ・い)(りん)
藜	(レイ)〜(あかざ)
鯏	(あさり)(うぐい)
離	(リ)〜(はな・れる)(はな・す)
蠡	(レイ)(ライ)(リ)(ラ)〜(にな)(ひさご)
籬	(リ)〜(まがき)(かき)『ませ
驪	(リ)(レイ)
礼	{禮}礼。(レイ)(ライ)〜(あや)(なり)(のり)(ひろし)(れ)『いや『うや『ゐや
李	(リ)〜(すもも)(もも)(い)
里	(リ)〜(さと)(さ)
俚	(リ)〜(いや・しい)
哩	(リ)〜(まいる)
浬	(リ)〜(かいり)(のっと)
理	(リ)〜(ことわり)(あや)(おさむ)(さと)(さとる)(ただ)(ただし)(とおる)(に)(のり)(ひ)(まこと)(まさ)(まさし)(まろ)(みち)(よし)『おさめる『きめ
裡	(リ)〜(うち)(うら)
豊	{豐}豊。(ホウ)(ブ)〜(ゆた・か)(とよ)(て)(で)(と)(ひろし)(ふう)(ぶん)(ほ)(ゆたか)
裏	(リ)〜(うら)『うち
禮	{禮}礼。(レイ)(ライ)〜(ひろ)(れ)『いや『うや『ゐや
鯉	(リ)〜(こい)『こひ
醴	(レイ)(ライ)〜(あまざけ)
鱧	(レイ)〜(はも)『はむ
力	(リョク)(リキ)(リイ)〜(ちから)(じから)(つとむ)
立	(リツ)(リュウ)(リットル)〜(た・つ)(た・つ)(た・ち)(た・てる)(た・てる)(た・て)(たて)(た・て)(だ・て)(だ・てる)(たち)(たっ)(たつ)(だて)(つい)『リフ
朸	(リョク)〜(おおご)(おうご)『あふご
吏	(リ)〜(さと)(し)
励	〔勵〕励。(レイ)〜(はげ・む)(はげ・ます)
利	(リ)〜(き・く)(かが)(と)(とし)(のり)(み)(りい)
苙	(リュウ)(キュウ)
例	(レイ)〜(たと・える)『ためし
戾	〔戾〕戻。もどす『もどる『レイ
隶	(タイ)〜(れいづくり)
茘	(レイ)(リ)(レン)〜(おおにら)
栃	(とち)『とちのき
俐	(リ)〜(かしこ・い)
莉	(リ)(ライ)(レイ)
莅	(リ)(レイ)〜(るい)(のぞ・む)(つ・く)
栗	(リツ)(リ)〜(くり)(おののく)(くる)(りっ)
砺	(レイ)〜(あらと)(みが・く)(と)
悧	(リ)
蛎	(レイ)〜(かき)
唳	(レイ)〜(れつ)
笠	(リュウ)〜(かさ)『リフ
粒	(リュウ)〜(つぶ)『つび『リフ
詈	(リ)〜(ののし・る)
痢	(リ)
慄	(リツ)〜(ふる・える)(おそ・れる)(おのの・く)
歴	{歷}歴。(レキ)(レッキ)『へる『リャク
暦	{曆}暦。(レキ)〜(こよみ)『リャク
綟	(レイ)〜(もじ)『もぢ
綟子	もじ『もぢ
隷	{隸}隷。(レイ)〜(したが・う)(しもべ)
勵	〔勵〕励。(レイ)〜(はげ・む)(はげ・ます)
歷	{歷}歴。へる『リャク『レキ
曆	{曆}暦。こよみ『リャク『レキ
篥	(リキ)(リツ)(リチ)
隸	{隸}隷。(レイ)〜(したが・う)(しもべ)
檪	(レキ)(ヤク)(ロウ)〜(くぬぎ)(いち)
癘	(レイ)(ライ)〜(えやみ)
櫟	(レキ)(ヤク)(ロウ)〜(くぬぎ)(いち)
麗	(レイ)〜(うるわ・しい)(うら・らか)(ま)(よし)(り)
礪	(レイ)〜(あらと)(みが・く)(と)
瀝	(レキ)〜(したた・る)
櫪	(レキ)〜(かいばおけ)(くぬぎ)
礫	(レキ)〜(つぶて)(こいし)『たびいし『たぶて
蠣	(レイ)〜(かき)
糲	(レイ)(ラツ)〜(あら・い)(くろごめ)
儷	(レイ)〜(つれあい)(ならぶ)
癧	(レキ)
轢	(レキ)〜(ひ・く)(きし・る)
轣	(レキ)
靂	(レキ)
怜	{憐}怜。(レイ)(レン)(リョウ)〜(あわ・れむ)(さと・い)(さと)(さとし)『リャウ
連	〔連〕連。(レン)〜(つら・なる)(つら・ねる)(つ・れる)(づ・れ)(ずれ)(つれ)(むらじ)(れ)『つら
連	〔連〕連。つらなる『つらねる『つれる『レン
蓮	(レン)〜(はす)(はちす)
嗹	(レン)〜(おしゃべり)
廉	〔廉〕廉。(レン)〜(きよ)『かど
廉	〔廉〕廉。レン
漣	(レン)(ラン)〜(さざなみ)
奩	(レン)〜(くしげ)(はこ)
聨	(レン)〜(つら・なる)(つら・ねる)
匳	(レン)〜(くしげ)(はこ)
憐	{憐}怜。(レン)〜(あわ・れむ)(あわ・れ)『リャウ『リョウ『レイ
濂	(レン)
縺	(レン)〜(もつ・れる)
聯	(レン)〜(つら・なる)(つら・ねる)
鎌	{鐮}鎌。(レン)(ケン)〜(かま)(かた)(かね)『かま
簾	(レン)〜(すだれ)(す)(みす)
鐮	{鐮}鎌。かま
斂	(レン)〜(おさ・める)
歛	(レン)
臉	(ケン)(セン)(レン)
恋	{戀}恋。(レン)〜(こ・う)(こい)(こい・しい)『こひ
楝	(レン)〜(おおち)(おうち)『あふち『せんだん
煉	{煉}錬。(レン)〜(ね・る)
練	〔練〕練。(レン)〜(ね・る)(ね・り)(ねり)
錬	{煉}錬。(レン)〜(ね・る)
鍊	{煉}鍊。レン
鏈	(レン)〜(くさり)
鰊	(レン)〜(にしん)『かど
瀲	(レン)〜(なぎさ)
戀	{戀}恋。(レン)〜(こ・う)(こい)(こい・しい)『こひ
簗	{築}簗。(リョウ)〜(やな)
良	(リョウ)〜(よ・い)(よ・い)(い・い)(い・い)(じ)(なが)(まこと)(よし)(ら)(りょ)(ろう)『ラウ『リャウ『リヤウ
良人	おっと『をつと
莨	(ロウ)〜(たばこ)
凉	(リョウ)〜(すず・しい)(すず・む)(すず・やか)(うす・い)(ひや・す)(まことに)
涼	(リョウ)〜(すず・しい)(すず・む)(すず・やか)(うす・い)(ひや・す)(まことに)(りょ)『ラウ『リャウ『リヤウ『ロウ
梁	(リョウ)〜(はり)(うつばり)(うちばり)(やな)(はし)『リャウ『リヤウ
椋	(リョウ)〜(むく)(ぐら)
粮	{糧}粮。(リョウ)(ロウ)〜(かて)『かりて『リヤウ
粱	(リョウ)〜(あわ)『おおあわ『おほあは『リャウ
糧	{糧}粮。(リョウ)(ロウ)〜(かて)『かりて『ラウ『リャウ『リヤウ
冫	(ヒョウ)〜(こおり)(にすい)
両	{兩}両。(リョウ)〜(てる)(ふたつ)(もろ)『リャウ『リヤウ『りゃん
兩	{兩}両。(リョウ)〜(ふたつ)『もんめ『リャウ『リヤウ『りゃん
倆	(リョウ)〜(たくみ)
裲	(リョウ)〜(うちかけ)
魎	(リョウ)〜(こだま)
亮	(リョウ)〜(あきらか)(あき)(すけ)(まこと)(あきら)(よし)(きょう)(たすく)(ふさ)『リャウ
量	(リョウ)〜(はか・る)(かず)『かさ『はか『ます『リャウ『リヤウ
喨	(リョウ)(ロウ)
輌	(リョウ)
踉	(ロウ)(リョウ)
輛	(リョウ)『リャウ
諒	(リョウ)〜(あきら・か)(まことに)(あき)(まさ)(まこと)『リャウ『リヤウ
鍄	(キョウ)
聊	(リョウ)〜(いささか)『レウ
僚	(リョウ)『レウ
寥	(リョウ)〜(さび・しい)『レウ
撩	(リョウ)(ロウ)
遼	(リョウ)〜(はるか)『レウ
潦	(ロウ)〜(にわたずみ)『にはたづみ
寮	(リョウ)『つかさ『レウ
暸	(リョウ)〜(あきらか)
燎	(リョウ)〜(かがりび)『レウ
療	(リョウ)『レウ
繚	(リョウ)〜(まと・う)(めぐ・る)
鷯	(リョウ)
蓼	(シン)(リク)(リョウ)〜(たで)
料	(リョウ)『はかる『レウ
廖	(リョウ)
瞭	(リョウ)〜(あきらか)『レウ
鐐	(リョウ)〜(あしかせ)
毟	(むし・る)
埓	(レツ)(ラツ)(ラチ)〜(らち・があく)(かこ・い)
列	(レツ)(レ)〜(れっ)『つら『つらなる『つらねる『れち
劣	(レツ)〜(おと・る)
冽	(レツ)(レイ)〜(きよ・い)
洌	(レツ)(レイ)〜(きよ・い)
埒	(レツ)(ラツ)(ラチ)〜(らち・があく)(かこ・い)
烈	(レツ)〜(はげ・しい)(やす)
捩	(レイ)(レツ)〜(よじ・る)(ね・じる)(ねじ・れる)(も・じる)
猟	{獵}猟。(リョウ)(レフ)〜(かり)(か・る)
裂	(レツ)〜(さ・く)(さ・ける)(ぎ・れ)『きれ
獵	{獵}猟。(リョウ)(レフ)〜(かり)(か・る)
鬣	(リョウ)〜(たてがみ)
林	(リン)〜(はやし)(し)
淋	(リン)〜(さび・しい)(さみ・しい)
琳	(リン)
鄰	{鄰}隣。(リン)〜(とな・る)(となり)
隣	{鄰}隣。(リン)〜(とな・る)(となり)(ちか)
霖	(リン)〜(ながあめ)『ながめ
燐	{磷}燐。(リン)
臨	(リン)〜(のぞ・む)(み)
磷	{磷}燐。リン
鱗	(リン)〜(うろこ)(こけ)(こけら)『いろくず『いろこ『うろくず『くづ
麟	(リン)
菻	(リン)
凛	(リン)〜(きびし・い)
凜	(リン)〜(きびし・い)
廩	(リン)〜(くら)
懍	(リン)(ラン)
吝	{吝}悋。(リン)〜(しわ・い)(やぶさ・かな)(おし・む)『やぶさか
悋	{吝}悋。(リン)〜(ねた・む)(やぶさか)(お・しむ)
賃	(チン)〜(すけ)
藺	(リン)〜(い)『ゐ
躙	(リン)〜(にじ・る)(ふ・む)
躪	(リン)〜(にじ・る)(ふ・む)
伶	(レイ)(リョウ)〜(わざおぎ)(れ)
苓	(レイ)(リョウ)〜(みみなぐさ)
囹	(レイ)
玲	(レイ)〜(たま)(あきら)(あき)(りょう)(れ)『リャウ
凌	(リョウ)〜(しの・ぐ)
陵	(リョウ)〜(みささぎ)『おか
聆	(レイ)(リョウ)〜(きく)
菱	(リョウ)〜(ひし)
菱喰	{菱餐}菱喰。くひ『ひしくい
菱餐	{菱餐}菱喰。くひ『ひしくい
蛉	(レイ)
崚	(リョウ)
羚	(レイ)(リョウ)〜(かもしか)
零	(レイ)〜(ぜろ)(こぼ・す)(こぼ・れる)
鈴	(レイ)(リン)〜(すず)(ず)
蔆	(リョウ)〜(ひし)
綾	(リン)〜(あや)(りょう)
霊	{靈}霊。(レイ)(リョウ)〜(たま)『すだま『たましい『ち『み『リャウ『リヤウ
鴒	(レイ)
澪	(レイ)〜(みお)
齢	{齡}齢。(レイ)〜(よわ・い)(とし)『よはひ
齡	{齡}齢。(レイ)〜(よわ・い)(とし)『よはひ
櫺	(レイ)(リョウ)〜(れんじ)
靈	{靈}霊。(レイ)(リョウ)〜(たま)『すだま『たましい『ち『み『リャウ『リヤウ
龗	おかみ
領	(リョウ)〜(よう)(よし)『うなじ『えり『くだり『くび『リャウ『リヤウ『レイ
嶺	(レイ)(リョウ)〜(みね)(ね)
令	(レイ)〜(のり)(りょう)(れ)『しむ『せしむ『のりごと『リャウ『リヤウ
溜	(リュウ)〜(た・まる)(たま・る)(た・める)(したた・る)(たまり)(ため)『リウ
畄	(リュウ)(ル)〜(と・める)(と・まる)(とど・める)(とど・まる)(るうぶる)
留	(リュウ)(ル)〜(と・める)(と・まる)(とど・める)(とど・まる)(るうぶる)(とめ)『リウ『ルーブル
流	(リュウ)(ル)〜(なが・れる)(なが・れ)(なが・す)(なが・す)(な)(ながれ)(めぐる)『リウ
流石	さすが
琉	{琉}瑠。(リュウ)(ル)
硫	(リュウ)『リウ
旒	(リュウ)〜(はたあし)『リウ
瑠	{琉}瑠。(ル)(リュウ)〜(るり)
榴	(ル)(リュウ)(リョウ)〜(ざくろ)
劉	(リュウ)(ル)〜(ころ・す)(らう)
瘤	(リュウ)(ル)〜(こぶ)『しいね『しひ『リウ
璢	(ル)(リュウ)
嚠	(リュウ)(ル)
餾	(リュウ)
瀏	(リュウ)〜(きよ・い)
鏐	(リュウ)
鰡	(リュウ)(ル)『ぼら
柳	(リュウ)〜(やなぎ)(なぎ)(や)(やい)(やぎ)(やな)(やない)『リウ
六	(ロク)(リク)〜(む)(む・つ)(むっ・つ)(むい)(く)(むつ)(ろっ)(ろつ)『むう『リウ『りゅう
澑	(リュウ)〜(た・まる)(たま・る)(た・める)(したた・る)(たまり)(ため)
霤	(リュウ)〜(あまだれ)
竜	{龍}竜。(リュウ)(リョウ)(ロウ)〜(たつ)(いせ)(りう)
隆	〔隆〕隆。(リュウ)〜(お)(たか)(たかし)
隆	〔隆〕隆。リュウ
槞	(ロウ)
嶐	(リュ)〜(やまのかたち)
篭	(ロウ)(ル)〜(かご)(こ・める)(こも・る)(こ・む)(ごめ)
龍	{龍}竜。(リュウ)(リョウ)(ロウ)〜(たつ)(りゅ)
窿	(リュウ)
𩸽	ほっけ
蘢	(ロウ)
瀧	{瀧}滝。(ロウ)(ソウ)〜(たき)『たき
瓏	(ロウ)
朧	(ロウ)〜(おぼろ)
籠	(ロウ)(ル)〜(かご)(こ・める)(こも・る)(こ・む)(ごめ)(もり)『こ
聾	(ロウ)〜(ろう・する)(つんぼ)(みみしい)『しひ
䪊頭	おもづら
隴	(ロウ)(リョウ)〜(おか)
壠	くろ
壟	(ロウ)(リョウ)〜(おか)(うね)(つか)
婁	(ル)(ロウ)〜(つな・ぐ)(ひ・く)(ろ)
楼	{樓}楼。(ロウ)〜(たかどの)
僂	(ロウ)(ル)〜(かが・む)
樓	{樓}楼。(ロウ)〜(たかどの)
螻	(ロウ)(ル)〜(けら)
髏	(ロ)
簍	(ル)(ロウ)
陋	(ロウ)〜(いや・しい)(せま・い)
漏	(ロウ)〜(も・る)(も・れる)(も・らす)『ロ
瘻	(ル)(ロウ)〜(せむし)(かさ)(できもの)
鏤	(ル)(ロウ)〜(ちりば・める)
芦	(ロ)〜(あし)(よし)(あ)
枦	(ロ)〜(はぜ)(はし)
炉	{爐}炉。(ロ)〜(いろり)
舮	(ロ)〜(とも)(へさき)
鈩	(ロ)〜(いろり)
盧	(ロ)
蘆	(ロ)〜(あし)(よし)
廬	(ロ)(リョ)〜(いお)(いおり)(いえ)『いほ『いほり
瀘	(ロ)
櫨	(ロ)〜(はぜ)『はじ『はぜのき
臚	(ロ)(リョ)
爐	{爐}炉。(ロ)〜(いろり)
艫	(ロ)〜(とも)(へさき)
纑	おがせ『を
轤	(ロ)
鑪	(ロ)〜(いろり)(たたら)
顱	(ロ)〜(かしら)(あたま)
鱸	(ロ)〜(すずき)
鹵	(ロ)〜(しお)(しおち)(たて)
虜	〔虜〕虜。(リョ)(ロ)〜(とりこ)(とりく)
虜	〔虜〕虜。リョ
滷	(ロ)
魯	(ロ)〜(おろか)
櫓	{櫓}艪。(ロ)〜(やぐら)(おおだて)
艪	{櫓}艪。(ロ)〜(やぐら)(かい)
陸	(リク)(ロク)〜(おか)(くが)(たち)(みち)(む)(むつ)『くぬが『をか
鹿	(ロク)〜(しか)(か)(しし)『かせぎ『かのしし『しか
鹿肉	かのしし
淕	(リク)(ロク)
禄	{祿}禄。(ロク)〜(さいわ・い)(ふち)(とし)(よし)
祿	{祿}禄。(ロク)〜(さいわ・い)(ふち)
輅	(ロ)〜(くるま)
碌	(ロク)〜(ろく・な)
賂	(ロ)〜(まいな・い)(まいな・う)『まひなひ
路	(ロ)(ル)〜(じ)(みち)『ち『ぢ
勠	(リク)〜(あわ・せる)
漉	(ロク)〜(こ・し)(こ・す)(す・く)
戮	(リク)(リュウ)(ロク)(キョウ)(ク)〜(ころ・す)(けず・る)
蕗	(ロ)(ル)〜(ふき)『ふふき
録	{錄}録。(ロク)『さかん『とる
錄	{錄}録。さかん『とる『ロク
轆	(ロク)〜(ころ)
麓	(ロク)〜(ふもと)
鯥	むつ
露	(ロ)(ロウ)〜(つゆ)(や)(ゆ)『あらは『あらわ『あらわす『あらわれる
鷺	(ロ)〜(さぎ)
巒	(ラン)〜(みね)
欒	(ラン)〜(おうち)(ひじき)(まどか)(まるい)
攣	(レン)〜(つ・る)(ひ・く)
臠	(レン)〜(みそな・わす)(きりみ)
鑾	(ラン)〜(すず)
鸞	(ラン)
卵	(ラン)〜(たまご)『かい『かいご『かひ
乱	{亂}乱。(ラン)(ロン)〜(みだ・れる)(みだ・る)(みだ・す)(みだ)(おさ・める)(わた・る)(ら)
亂	{亂}乱。(ラン)(ロン)〜(みだ・れる)(みだ・る)(みだ・す)(みだ・れ)(おさ・める)(わた・る)
掠	(リャク)(リョウ)〜(かす・める)(かす・る)(かす・れる)(ぐら)
擽	(リャク)(ラク)(レキ)(フキ)〜(くすぐ・る)(う・つ)
侖	(リン)(ロン)〜(おも・う)
倫	(リン)〜(とも)(のり)(ひとし)(ひろ)(みち)
崘	(ロン)
崙	(ロン)
淪	(リン)(ロン)〜(しず・む)
棆	(リン)
綸	(リン)(カン)〜(いと)
輪	(リン)〜(わ)(なわ)(も)
論	(ロン)『あげつらう
螺	(ラ)〜(にし)(にな)『つぶ
羅	(ラ)『うすぎぬ
騾	(ラ)
蘿	(ラ)〜(つた)『かげ『こけ
邏	(ラ)〜(めぐ・る)
鑼	(ラ)〜(どら)
裸	(ラ)〜(はだか)
裸足	はだし
瘰	(ルイ)(ラ)(ライ)
洛	(ラク)
珞	(ラク)
落	(ラク)〜(お・ちる)(お・ち)(お・とす)(おち)
絡	(ラク)〜(から・む)(から・まる)『からめる
犖	(ラク)〜(まだらうし)
閭	(リョ)(ロ)〜(さと)
櫚	(ロ)(リョ)
驢	(ロ)(リョ)〜(うさぎうま)
呂	(ロ)(リョ)〜(せぼね)(とも)(なが)
侶	(リョ)(ロ)〜(とも)
梠	(ロ)(リョ)〜(ひさし)
旅	(リョ)〜(たび)
稆	{稆}穭。ひつじ『ひつぢ
屡	{屢}屡。(ル)〜(しばしば)『しば
屡々	{屢々}屡々。しばしば
絽	(ロ)(リョ)
膂	(リョ)(ロ)〜(せぼね)
屢	{屢}屡。しば『しばしば『ル
屢々	{屢々}屡々。しばしば
履	(リ)〜(は・く)『くつ『ふむ
褸	(ロ)(ル)(ロウ)〜(いと)
縷	(ル)(ロウ)〜(いと)
穭	{稆}穭。ひつじ『ひつぢ
律	(リツ)(リチ)(レツ)〜(たかし)(のり)
率	(ソツ)(リツ)(シュツ)〜(ひき・いる)
葎	(リツ)〜(むぐら)(つ)
緑	{綠}緑。(リョク)(ロク)〜(みどり)
綠	{綠}緑。みどり『リョク『ロク
慮	(リョ)〜(おもんぱく・る)(おもんぱか・る)(ぜ)
濾	(ロ)(リョ)〜(こ・す)
鑢	(ロ)(リョ)〜(やすり)
略	(リャク)〜(ほぼ)(おか・す)(おさ・める)(はかりごと)(はか・る)(はぶ・く)(りゃく・す)(りゃく・する)
畧	(リャク)〜(ほぼ)(おか・す)(おさ・める)(はかりごと)(はか・る)(はぶ・く)
媽	(ボ)(モ)〜(はは)
麻	(マ)(マア)〜(あさ)(あ)(あざ)(お)『そ『を
麻笥	おけ『を
麻桛	おがせ『を
痲	(マ)(バ)〜(しび・れる)
痳	(リン)
蟇	{蟆}蟇。(バ)(マ)〜(ひき)『がへる『がま『がまがえる
蟆	{蟆}蟇。(バ)(マ)〜(ひき)『がへる『がま『がまがえる
蟆子	ぶと『ぶゆ『ぶよ
馬	(バ)〜(うま)(うま)(た)(ばん)(め)(も)『マṬ『むま
馬城	うまき『むまき
馬刀	まて
馬蛤	まて
瑪	(メ)(バ)
碼	(バ)(メ)〜(やあど)(やある)『ヤード
罵	(バ)〜(ののし・る)
嘛	(マ)
埋	(マイ)〜(う・める)(う・まる)(う・もれる)(うず・める)(うず・まる)(い・ける)
霾	(バイ)〜(つちふる)
買	(バイ)〜(か・う)
買い米	かいよね『かひ
麦	{麥}麦。(バク)〜(むぎ)
売	{賣}売。(バイ)〜(う・る)(う・れる)(うり)(うる)(め)『マイṬ
売り米	うりよね
脉	{脈}脉。(ミャク)〜(すじ)
脈	{脈}脉。(ミャク)〜(すじ)
麥	{麥}麦。(バク)〜(むぎ)
賣	{賣}売。(バイ)〜(う・る)(う・れる)『マイṬ
賣り米	うりよね
邁	(マイ)(バイ)〜(ゆ・く)(すす・む)
悗	(バン)(マン)
蛮	〔蠻〕蛮。(バン)〜(えびす)
瞞	(マン)(モン)(バン)(ボン)〜(だま・す)
饅	(マン)『ぬた
鬘	(バン)(マン)〜(かつら)(かずら)『かづら
鰻	(マン)(バン)〜(うなぎ)『うな『むなぎ
蠻	〔蠻〕蛮。(バン)〜(えびす)
満	〔滿〕満。(マン)(バン)〜(み・ちる)(み・つ)(み・たす)(ま)(みち)(みつ)(みつる)
滿	〔滿〕満。(マン)(バン)〜(み・ちる)(み・つ)(み・たす)
曼	(マン)(バン)〜(なが・い)
蔓	(マン)(バン)〜(はびこ・る)(つる)『かずら『かづら『つら
幔	(マン)(バン)〜(まく)
漫	(マン)〜(みがりに)『すずろ『そぞろ
慢	(マン)
縵	(マン)(バン)
謾	(マン)(バン)〜(あざむ・く)(あなど・る)
鏝	(マン)〜(こて)
蘰	(かつら)
芒	(ボウ)(コウ)(モウ)〜(すすき)(のぎ)(のげ)『バウ『はしか
忙	(ボウ)(モウ)〜(いそが・しい)(せわ・しい)(おそ・れる)(うれえるさま)『バウ
尨	(ボウ)〜(むくいぬ)『むく
盲	(モウ)〜(めくら)『しひ『マウ『めしい
氓	(ボウ)〜(たみ)
茫	(ボウ)〜(とお・い)『バウ
厖	(ボウ)〜(おおき・い)
鋩	(ボウ)〜(ほこさき)(きっさき)
莽	(ボウ)(モウ)〜(くさ)『バウ『マウ
蟒	(ボウ)(モウ)〜(うわばみ)(おろち)
蠎	(ボウ)(モウ)〜(うわばみ)(おろち)
猫	{貓}猫。(ビョウ)〜(ねこ)『ベウ『ミョウ『メウ
貓	{貓}猫。ねこ『ビョウ『ベウ『ミョウ『メウ
毛	(モウ)〜(け)(めん)(も)
矛	(ム)(ボウ)〜(ほこ)
茆	(エン)(ボウ)〜(その)(かや)(ぬなわ)
茅	(ボウ)(ミョウ)〜(かや)(ちがや)(ち)(じ)『バウ
茅萱	ちがや
旄	(ボウ)(モウ)
髦	(ボウ)(モウ)〜(たれがみ)
錨	(ビョウ)(ミョウ)〜(いかり)『ベウ
卯	(ボウ)(モウ)〜(う)(あきら)(しげる)(い)『バウ
夘	(ボウ)〜(う)
昴	(コウ)(ボウ)〜(すばる)『バウ
鉚	(リュ)〜(よいかね)
皃	(ボウ)(バク)〜(かたち)(かたどる)
茂	(モ)〜(しげ・る)(うむさ)(き)(し)(つとむ)(む)(もて)
冒	(ボウ)〜(おか・す)
耄	(ボウ)(モウ)〜(おいぼ・れる)
袤	(ボウ)〜(ながさ)
帽	(ボウ)(モウ)〜(ずきん)(おお・う)
貿	(ボウ)
瑁	(マイ)(バイ)(ボウ)(モウ)
楙	(ボウ)〜(しげる)
獏	{貘}獏。(バク)(ミャク)
貌	(ボウ)(バク)〜(かたち)(かたどる)『バウ
懋	(ボウ)〜(し・げる)(つと・める)
麼	(ビ)(ミ)(バ)(マ)(モ)
沒	{沒}没。(ボツ)(モツ)〜(おぼ・れる)(しず・む)(ない)
没	{沒}没。(ボツ)(モツ)〜(おぼ・れる)(しず・む)(ない)
苺	{莓}苺。(バイ)(マイ)〜(いちご)
枚	(マイ)(バイ・・)〜(ひら・・)『びら
栂	{梅}栂。(つが)(とが)
眉	(ビ)(ミ)〜(まゆ)『まみ『まみえ『まよ
莓	{莓}苺。(バイ)(マイ)〜(いちご)
梅	{梅}栂。(バイ)〜(うめ)『つが『とが『むめ
梅花皮	かいらぎ
嵋	(ビ)
媒	(バイ)『なこうど
媒鳥	おとり『を
楳	(バイ)〜(うめ)
煤	(バイ)(マイ)〜(すす)
霉	{霉}黴。かび『かびる『バイ
黴	{霉}黴。(バイ)(ビ)(マイ)(ミ)〜(かび)(か・びる)
毎	{每}毎。(マイ)〜(ごと)(ごと・に)(つね)
每	{每}毎。ごと『マイ
美	(ビ)(ミ)〜(うつく・しい)(はる)(よし)(よしみ)(り)
躾	(しつ・ける)(しつけ)
妹	(マイ)〜(いもうと)(す)(せ)(も)『いも『いもと
昧	(マイ)(バイ)〜(くら・い)(むさぼ・る)
袂	(ベイ)(ケツ)〜(たまと)(たもと)
眛	(マイ)(バイ)〜(くら・い)
寐	(ビ)〜(ね・る)
媚	(ビ)〜(こ・びる)(こび)
魅	(ミ)
椚	(くにぎ)(くぬぎ)
門	(モン)〜(かど)(と)(じょう)(も)
捫	(モン)〜(な・でる)
悶	(モン)〜(もだ・える)(もだえ・る)
懣	(マン)(モン)〜(もだ・える)
們	(モン)〜(ともがら)
虻	{虻}蝱。(ボウ)〜(あぶ)『あむ
萌	(ホウ)〜(も・える)(きざ・す)(めばえ)(きざ・し)(もえ)(きざし)『ハウ
萌やし	もやし
蒙	(モウ)(ボウ)〜(こうむ・る)(おお・う)(くら・い)
盟	(メイ)『ちかい『ちかう
甍	(ボウ)(ミョウ)〜(いらか)
儚	(ボウ)(モウ)〜(はかな・い)(くら・い)
蝱	{虻}蝱。あぶ
濛	(モウ)〜(こさめ)
檬	(モウ)
曚	(モウ)(ボウ)〜(くら・い)
朦	(モウ)(ボウ)〜(おぼろ)
矇	(モウ)(ボウ)〜(くら・い)(めし・い)
艨	(モウ)(ボウ)〜(いくさぶね)
猛	(モウ)〜(たけ)(たけし)(たける)『マウ
孟	(モウ)(ボウ)(ミョウ)〜(かしら)(たけし)(たけ)(はる)(はじめ)(つとむ)(おさ)(はい)『マウ
梦	(ム)(ボウ)〜(ゆめ)(ゆめ・みる)(くら・い)
夢	(ム)(ボウ)〜(ゆめ)(ゆめ・みる)(くら・い)『いめ
弥	{彌}弥。(ミ)(ビ)〜(いや)(や)(あまねし)(いよいよ)(とおい)(ひさし)(ひさ・しい)(わた・る)(わたる)(みつ)(ひろ)(よ)『いよ
迷	(メイ)〜(まよ・う)
祢	(ネ)(デイ)(ナイ)
袮	(デイ)(ネ)
謎	(メイ)(ベイ)〜(なぞ)『なぞ
糜	(ビ)〜(ただ・れる)
縻	(ビ)(ミ)〜(きずな)
麋	(ビ)〜(なれしか)
彌	{彌}弥。(ミ)(ビ)〜(いや)(や)(あまねし)(いよいよ)(とおい)(ひさし)(ひさ・しい)(わた・る)(ゆ)『いよ
禰	(ネ)(デイ)(ナイ)
靡	(ヒ)(ビ)(ミ)〜(なび・く)(ない)(わ・ける)
米	(ベイ)(マイ)(メエトル)〜(こめ)(よね)(は)(べ)(まべ)(め)(よ)(よな)(よの)(よま)『メートル『めめ
弭	(ビ)(ミ)〜(や・める)(や・む)(ゆは・ず)『はず
濔	(ビ)
瀰	(ビ)(ミ)
糸	〔絲〕糸。(シ)〜(いと)
汨	(コツ)(イツ)(ベキ)〜(しず・む)
泌	(ヒツ)(ヒ)『しみる
祕	〔祕〕秘。(ヒ)〜(ひ・める)(かく・す)
秘	〔祕〕秘。(ヒ)〜(ひ・める)(ひそ・か)(かく・す)
覓	(ベキ)(エキ)(ミャク)〜(もと・める)
密	(ミツ)〜(ひそ・か)『みそか
幎	(ベキ)〜(とばり)
蜜	(ミツ)(ビツ)『みち
樒	(ミツ)〜(しきみ)(じんこう)『しきび
冪	{冪}羃。(ベキ)
謐	(ヒツ)〜(しずか)
櫁	(ミツ)〜(しきみ)(じんこう)
羃	{冪}羃。(ベキ)
杣	(そま)
眠	(ミン)〜(ねむ・る)(ねむ・い)(ね)
棉	(メン)〜(わた)
綿	(メン)〜(わた)(う)
緜	(メン)〜(わた)(つら・なる)
免	〔免〕免。(メン)〜(まぬか・れる)(まぬが・れる)(め)
眄	(ベン)(メン)〜(かえり・みる)
俛	(フ)(ベン)(メン)〜(ふ・せる)
勉	〔勉〕勉。(ベン)〜(つと・める)(ひこ)(やつ)
娩	(ベン)『うむ
冕	(ベン)(メン)〜(かんむり)
湎	(メン)(ベン)〜(おぼ・れる)(しず・む)
緬	(メン)(ベン)
面	(メン)(ベン)〜(おも)(おもて)(つら)(お)(ずら)(ほおつき)(も)『づら『もて
面掛	おもがい
面皰	にきみ
面繋	おもがい
面懸	おもがい
麪	(メン)(ベン)〜(むぎこ)
麺	〔麵〕麺。(メン)(ベン)〜(むぎこ)
麵	〔麵〕麺。メン
苗	(ビョウ)(ミョウ)〜(なえ)(なわ)(ねい)(のら)(みう)(みつ)『なへ『ベウ『メウ
描	(ビョウ)〜(えが・く)(か・く)『ベウ
杪	(ビョウ)(ショウ)〜(こずえ)『すはえ『すわえ『ずゑ
眇	(ビョウ)(ミョウ)〜(びょう・たる)(すがめ)『ベウ
秒	(ビョウ)『ベウ
渺	(ビョウ)〜(びょう・たる)『ベウ
緲	(ビョウ)(ミョウ)
藐	(ビョウ)(バク)〜(かろ・んじる)(とお・い)
妙	(ミョウ)(ビョウ)〜(たえ)『たへ『ベウ『メウ
廟	(ビョウ)(ミョウ)〜(たまや)(みたまや)(やしろ)『ベウ
繆	(ビュウ)(キュウ)(ボク)(リョウ)〜(あやま・る)(まと・う)(こら)
滅	(メツ)〜(ほろ・びる)(ほろ・ぶ)(ほろ・ぼす)
蔑	(ベツ)〜(ないがしろ)(なみ・する)(くらい)(さげす・む)
民	(ミン)〜(たみ)(ひと)(み)
旻	(ビン)(ミン)〜(あきぞら)
岷	(ビン)(ミン)
罠	(ビン)(ミン)〜(わな)(あみ)
緡	(ビン)(コン)(ミン)〜(さし)(つりいと)(なわ)(ぜにさし)
皿	(ベイ)〜(さら)
泯	(ビン)(ベン)(ミン)(メン)〜(ほろ・びる)
敏	〔敏〕敏。(ビン)〜(さとい)(さとし)(ちょう)(とし)(び)『とし
閔	(ビン)(ミン)〜(あわ・れむ)(うれ・える)
黽	(ボウ)(ビン)(ベン)(ミン)(メン)〜(あおが・える)(つと・める)
愍	(ビン)(ミン)〜(あわ・れむ)
閩	びん
憫	(ビン)(ミン)〜(あわれ・む)(うれ・える)
名	(メイ)(ミョウ)〜(な)(な)(と)『ミャウ
名吉	なよし
明	(メイ)(ミョウ)(ミン)〜(あ・かり)(あか・るい)(あか・るむ)(あか・らむ)(あき・らか)(あ・ける)(あ・け)(あ・く)(あ・くる)(あ・かす)(あきら)(あけ)(あす)(きら)(け)(さや)(さやか)(とし)(はる)(み)(め)『ミャウ
茗	(ミョウ)(メイ)〜(ちゃ)『ミャウ
冥	(メイ)(ミョウ)〜(くら・い)『ミャウ
溟	(メイ)〜(うみ)(くら・い)
榠	(ベイ)
暝	(メイ)(ミョウ)〜(くら・い)
鳴	(メイ)〜(な・く)(な・る)(な・らす)(なり)(なる)『ミャウ『ミョウ
銘	(メイ)〜(たか)(み)(め)
瞑	(メイ)(ベン)(ミョウ)(ミン)(メン)〜(めい・する)(つぶ・る)(つむ・る)(くら・い)
螟	(メイ)(ミョウ)〜(ずいむし)
酩	(メイ)〜(よう)
命	(メイ)(ミョウ)〜(いのち)『みこと『ミャウ
掵	(ハバ)
謬	(ビュウ)(ビョウ)(ミュウ)〜(あやま・る)『あやまり『ビウ
摸	(モ)(モウ)(バク)(ボ)(マク)
模	(モ)(ボ)〜(がみ)
膜	(マク)
摩	(マ)〜(ま・する)(さ・する)(す・る)『こする
橅	ぶな
磨	(マ)〜(みが・く)(す・る)(おさむ)『とぐ
糢	(ボ)(モ)〜(かた)(のっとる)
謨	(ボ)(モ)〜(はか・る)
魔	(マ)
抹	(マツ)
麿	(まろ)(ま)
末	(マツ)(バツ)〜(すえ)『うら『うれ『すゑ
茉	(マツ)(バツ)(マ)〜(み)
歿	(ボツ)〜(しぬ)
冐	(ボウ)〜(おか・す)
沫	(マツ)(バツ)〜(あわ)(しぶき)(つばき)
陌	(ハク)〜(まち)(みち)(はざ)
莫	(バク)(ボ)(マク)(モ)(ナイ)〜(くれ)(なか・れ)(なし)『まな
秣	(マツ)(バツ)〜(まぐさ)(まぐさかう)
貊	(ハク)(ミャク)〜(えびす)
貉	{貉}狢。(カク)(ハク)〜(むじな)『もじな
漠	(バク)
寞	(バク)(マク)〜(さび・しい)
靺	(マツ)(バツ)
黙	{默}黙。(モク)(ボク)〜(だま・る)(もだ・す)『もだ
墨	〔墨〕墨。(ボク)〜(すみ)(すの)
默	{默}黙。(ボク)(モク)〜(だ・まる)(もだ・す)『もだ
貘	{貘}獏。(バク)(ミャク)
驀	(バク)
牟	(ボウ)(ム)
牟礼	{牟禮}牟礼。むれ
牟禮	{牟禮}牟礼。むれ
桙	(ウ)〜(ほこ)
眸	(ボウ)(ム)〜(ひとみ)
鉾	(ボウ)(ム)〜(ほこ)
謀	(ボウ)(ム)〜(はか・る)(たばか・る)(はかりごと)
鴾	(ボウ)〜(とき)『つき
某	(ボウ)〜(それがし)(なにがし)『くれ『くれがし
嘸	(ブ)(ム)〜(さぞ)(さぞや)(さぞかし)
母	(ボ)〜(はは)(も)『あも『おも『かか『はわ
母衣	ほろ
牡	(ボ)(ボウ)〜(おす)(お)(おん)『をす
拇	(ボ)〜(おやゆび)
姆	(ボ)(モ)〜(うば)
畆	(ボウ)(ホ)(モ)(ム)〜(せ)(うね)
畝	(ボウ)(ホ)(モ)(ム)〜(せ)(うね)『うね
鉧	けら
木	(ボク)(モク)〜(き)(こ)(ぐ)(も)(もと)『け
木鋤	こすき
木叢	こむら
木槿	むくげ
木樵	きこり
木屑	こけら
目	(モク)(ボク)〜(め)(め)(ま)(さかん)(さがん)(さっか)(さつか)
凩	(こがらし)
沐	(モク)〜(もく・する)(あら・う)
苜	(モク)(ボク)
牧	(ボク)〜(まき)(ま)(まい)(もく)『うまき『むまき
募	(ボ)〜(つの・る)
墓	(ボ)〜(はか)
幕	(マク)(バク)
睦	(ボク)(モク)〜(むつ・まじい)(むつ・む)(むつ・ぶ)(むつ)(ちか)(よし)(あつ)(む)(むね)
慕	(ボ)〜(した・う)
暮	(ボ)〜(く・れる)(く・らす)(ぐらし)(ぐれ)(ぽ)
樢	(ト)(チョウ)〜(つた)
穆	(ボク)(モク)〜(やわ・らぐ)
拏	(ダ)(ナ)〜(つか・む)(ひ・く)
拿	(ダ)(ナ)〜(つか・む)(ひ・く)
雫	(ダ)〜(しずく)『しづく
那	(ナ)(ダ)〜(なに)(なんぞ)(いかん)(とも)(やす)『どの『どれ
吶	(トツ)〜(ども・る)
肭	(トツ)(ジク)
衲	(ドウ)(ノウ)〜(ころも)『ナフ
娜	(ダ)(ナ)
納	(ノウ)(ナッ)(ナ)(ナン)(トウ)〜(おさ・める)(おさ・める)(おさ・まる)(の)(ろ)『いれる『タフ『ナフ
捺	(ナツ)(ダツ)〜(さ・す)(お・す)
靹	(ケツ)
乃	(ナイ)(ダイ)(ノ)(アイ)〜(の)(すなわ・ち)(なんじ)(おさむ)(お)(のり)
乃公	おれ
廼	(ナイ)(ダイ)(ノ)(アイ)〜(すなわ・ち)(なんじ)
迺	(ナイ)(ダイ)(アイ)〜(の)(すなわ・ち)(なんじ)
奈	(ナ)(ナイ)(ダイ)〜(いかん)(からなし)『いかんぞ
耐	(タイ)〜(た・える)(たえ)
男	(ダン)(ナン)〜(おとこ)(お)(み)『おのこ『を『をと
男の子	おのこ『を
南	(ナン)(ナ)〜(みなみ)(なみ)(は)(みな)(みまみ)『みんなみ
娚	(ナン)〜(めおと)
遖	(あっぱれ)
喃	(ナン)〜(の・う)『なう
楠	(ナン)(ダン)(ゼン)(ネン)〜(くす)(くすのき)(くず)(な)
難	〔難〕難。(ナン)〜(かた・い)(がた・い)(むずか・しい)(むづか・しい)(むつか・しい)(にく・い)(な)(なに)
赧	(タン)〜(あから・める)
嚢	{囊}嚢。(ノウ)(ドウ)〜(ふくろ)『ナウ
囊	{囊}嚢。ナウ『ノウ『ふくろ
曩	(ノウ)(ドウ)〜(さき・に)『さき『ナウ
呶	(ド)(ドウ)〜(かまびす・しい)
撓	(トウ)(キョウ)(コウ)(ジョウ)〜(たわ・む)(しな・う)(しお・る)(たわ・める)(みだ・す)(みだ・れる)『しおり『しをり『タウ『ダウ『たお『たわ『たわわ『たを『ドウ『とおお『とをを
𩊱	しころ
鐃	(ドウ)(ニョウ)〜(どら)『ネウ
悩	〔惱〕悩。(ノウ)〜(なや・む)(なや・ます)(なや・ましい)(なやみ)『ナウ
脳	{腦}脳。(ノウ)(ドウ)〜(のうずる)『ナウ『なずき『なづき
惱	〔惱〕悩。(ノウ)〜(なや・む)(なや・ます)(なや・ましい)(なやみ)『ナウ
瑙	(ノウ)
腦	{腦}脳。(ノウ)(ドウ)〜(のうずる)『ナウ『なずき『なづき
嫐	(ドウ)(ジョウ)〜(なぶ・る)『うはなり『うわなり
碯	(ノウ)
閙	(ドウ)(トウ)〜(さわが・しい)
鬧	(トウ)(ドウ)〜(さわが・しい)
訥	(トツ)〜(ども・る)
餒	(ダイ)(イ)〜(う・える)
內	{內}内。うち『ダイ『ナイ
内	{內}内。(ナイ)(ダイ)〜(うち)(いと)(ただ)(ち)(のち)
嫩	(ドン)(ノン)〜(わか・い)
能	(ノウ)〜(よ・く)(たか)(の)(のり)(よし)『あたう『え『よくする
尼	(ニ)〜(あま)『ジ『ヂ
泥	{泥}埿。(デイ)(ナイ)(デ)(ニ)〜(どろ)(ひじ)『うき『こひじ『なずむ『ひじりこ『ひぢ『ひぢり
泥鰍	{泥鰍}泥鰌。どじょう『どぢやう
泥鰌	{泥鰍}泥鰌。どじょう『どぢやう
怩	(ジ)
籾	(もみ)
倪	(ゲイ)(ガイ)〜(きわ)
猊	(ゲイ)
埿	{泥}埿。うき『ひじ『ひぢ
貎	(ゲイ)
霓	(ゲイ)〜(にじ)
鯢	(ゲイ)〜(さんしょううお)
麑	(ゲイ)(ベイ)〜(こじか)(かのこ)
你	{你}儞。おれ
儞	{你}儞。おれ
擬	(ギ)〜(まが・い)(もど・き)『なぞらえる『はかる
昵	(ジツ)(ショク)〜(ちかづ・く)『ヂツ
逆	(ギャク)(ゲキ)〜(さか)(さか・さ)(さか・らう)
逆しま	さかしま
逆鉤	あぐ
匿	(トク)〜(かくま・う)『かくす
眤	(ケイ)(ダイ)〜(てい)(い)
睨	(ゲイ)〜(にら・む)(にら・み)『ねめる
溺	(デキ)(ジョウ)(ニョウ)〜(いばり)(おぼ・れる)
膩	(ジ)(ニ)〜(あぶら)(あぶらあか)
拈	(ネン)(セン)(デン)〜(ひね・る)
年	(ネン)〜(とし)(ね)『とせ
年魚	あゆ
鮎	{鯰}鮎。(デン)(ネン)〜(あゆ)(なまず)(あい)
鵇	とき
黏	(ネン)〜(ねば・り)(ねば・る)
鯰	{鯰}鮎。(ネン)〜(なまず)『あゆ『なまづ
捻	{捻}撚。(ネン)(ジョウ)〜(ね・じる)(ねじ・る)(ひね・くる)(ひね・る)『より『よる
輦	(レン)〜(たごし)(てぐるま)
撚	{捻}撚。(ネン)〜(よ・る)(よ・れる)(より)(ひね・る)
碾	(テン)〜(ひ・く)(う・す)
廿	(ジュウ)(ニュウ)〜(にじゅう)(はつ)『はたち
念	(ネン)『おもう
唸	(テン)〜(うな・る)(うなり)
娘	{娘}嬢。(ジョウ)〜(むすめ)(こ)『ヂャウ『ヂヤウ『むすめ
嬢	{娘}嬢。(ジョウ)〜(むすめ)『ヂャウ『ヂヤウ
醸	〔釀〕醸。(ジョウ)〜(かも・す)『ヂャウ
釀	〔釀〕醸。(ジョウ)〜(かも・す)『ヂャウ
鳥	(チョウ)〜(とり)(か)(と)(とっ)『テウ
鳥黐	とりもち
鳥栖	{鳥棲}鳥栖。とぐら
鳥棲	{鳥棲}鳥栖。とぐら
鳥臓	ももげ
鳥座	とぐら
嫋	(ジョウ)(ジャク)(デキ)〜(なよ・やかな)(しなや・か)(たお・やか)
蔦	(チョウ)〜(つた)(たつ)
嬲	(ドウ)(ジョウ)〜(なぶ・る)
尿	(ニョウ)『いばり『しい『しし『しと『ネウ『ばり『ゆばり『ゆまり
捏	(ネツ)(テツ)(ネチ)〜(こ・ねる)(ね・る)(つく・ねる)『デツ
涅	(ネツ)(デツ)〜(そ・める)『くり
噛	(コウ)(ゴウ)〜(か・む)(か・じる)
聶	(ショウ)(ジョウ)(ニョウ)〜(ささや・く)
蘖	(ゲツ)〜(ひこばえ)『もやし
齧	(ゲツ)(ケツ)〜(かじ・る)(か・む)
囁	(ショウ)〜(ささや・く)
囓	(ゲツ)(ケツ)〜(かじ・る)(か・む)
躡	(ジョウ)〜(ふ・む)
鑷	(セツ)(ジョウ)(ニョウ)〜(けぬき)(けぬ)
顳	(ショウ)
恁	(イン)(ジン)(ニン)
寧	(ネイ)〜(むし・ろ)(あき)(やす)(やすし)(よし)『ニャウ『ニョウ
凝	(ギョウ)〜(こ・る)(こ・らす)(こご・らす)(こご・らせる)(こご・る)
嚀	(ネイ)(ニョウ)
獰	(ドウ)(ネイ)〜(わる・い)『ダウ
檸	(ネイ)(ドウ)
聹	(ネイ)
佞	(ネイ)〜(おもね・る)(よこしま)
侫	(ネイ)〜(おもね・る)(よこしま)
濘	(ネイ)〜(ぬか・る)
牛	(ギュウ)〜(うし)(うじ)(ご)『ギウ
牛尾魚	こち
狃	(ジュウ)〜(な・れる)(なら・う)
忸	(ジク)(ジュウ)〜(はじ・る)
紐	(チュウ)(ジュウ)〜(ひも)『チウ『ヂウ『ひぼ
鈕	(チュウ)(ジュウ)〜(ぼたん)(つまみ)『チウ
拗	(オウ)(ヨウ)(イク)(ユウ)〜(ねじ・れる)(こじ・れる)(す・ねる)(ねじ・ける)『エウ『ねじる
農	(ノウ)〜(な)(の)(み)
儂	(ドウ)(ノウ)〜(わし)(かれ)
濃	(ノウ)〜(こ・い)(の)『こ
膿	(ノウ)(ドウ)〜(う・む)(うみ)
弄	(ロウ)(ル)〜(いじく・る)(ろう・する)(いじ・る)(ひねく・る)(たわむ・れる)(もてあそ・ぶ)
耨	(ドウ)(ジョク)(ヌ)(ジュク)〜(くさぎ・る)(くわ)(すき)
奴	(ド)〜(やつ)(やっこ)(ぬ)『しゃつ『つぶね『め『やつこ
孥	(ド)(ヌ)〜(つまこ)
駑	(ド)〜(にぶ・い)
努	(ド)〜(つと・める)『ゆめ
弩	(ド)〜(おおゆみ)(いしゆみ)
怒	(ド)(ヌ)〜(いか・る)(おこ・る)
暖	(ダン)(ノン)〜(あたた・か)(あたた・かい)(あたた・まる)(あたた・める)
虐	(ギャク)〜(しいた・げる)
瘧	(ギャク)(ガク)〜(おこり)『わらは『わらわやみ
梛	(ダ)(ナ)〜(なぎ)
儺	(ナ)(ダ)〜(おにやらい)
搦	(ジャク)(ジョク)(ダク)(ニャク)〜(から・める)(がら・み)
諾	(ダク)『う『うべ『うべなう『お『せ『むべ『を
懦	(ダ)(ジュ)(ゼン)〜(よわ・い)
糯	(ダ)(ナ)〜(もちごめ)『もち
女	(ジョ)(ニョ)(ニョウ)〜(おんな)(め)(おな)(た)(つき)(な)『おうな『おみな『ヂョ『ヂヨ『をうな『をみな『をんな
衂	(ジク)〜(はなぢ)
衄	(ジク)〜(はなぢ)
哦	(ガ)
欧	〔歐〕欧。(オウ)〜(うた・う)(は・く)(おお)(ひろ)
殴	〔毆〕殴。(オウ)〜(なぐ・る)
甌	(オオ)(オウ)〜(ほとぎ)(はち)(かめ)
歐	〔歐〕欧。(オウ)〜(うた・う)(は・く)
毆	〔毆〕殴。(オウ)(ク)〜(なぐ・る)(たた・く)
鴎	{鷗}鴎。(オウ)〜(かもめ)『かまめ
謳	(オウ)(ウ)〜(うた・う)
鷗	{鷗}鴎。かまめ『かもめ
偶	(グウ)〜(たま)『たまたま
嘔	(オウ)(ク)〜(は・く)(むかつ・く)(うた・う)
藕	(グウ)(グ)(ゴウ)〜(はすのね)
葩	(ハ)〜(はな)
葩煎	はぜ
杷	(ハ)〜(つか)(わ)
爬	(ハ)〜(か・く)
耙	(ハ)
琶	(ハ)(ベ)(ワ)
怕	(ハク)(ヒャク)(ハ)〜(かしわ)(おそ・れる)
袙	(バツ)(ハ)〜(あこめ)
拍	(ハク)(ヒョウ)『うつ『ヒャウ
俳	(ハイ)
排	(ハイ)〜(おし)
徘	(ハイ)〜(さまよ・う)
牌	(ハイ)〜(ぱい)(ふだ)
派	(ハ)
湃	(ハイ)
萠	(ホウ)〜(も・える)(きざ・す)(めばえ)(きざ・し)(めぐむ)
潘	(ハン)
攀	(ハン)〜(よ・じる)
爿	(ショウ)(ソウ)〜(しょうへん)
槃	(ハン)〜(たら・い)
磐	(バン)(ハン)〜(いわ)(いわお)(わ)『いは
盤	(バン)〜(ち)(わ)『さら
蹣	(マン)(ハン)〜(よろ・めく)
蟠	(ハン)〜(わだかま・る)(わらじむし)『バン
判	(ハン)(バン)〜(わか・る)
叛	(ハン)(ホン)〜(そむ・く)
畔	(ハン)〜(あぜ)(ぐろ)『くろ『ほとり
袢	(ハン)
滂	(ホウ)(ボウ)
彷	(ホウ)〜(さまよ・う)『ハウ
旁	(ボウ)(ホウ)〜(つくり)(かたがた)(かたわら)『バウ『はら
膀	(ボウ)(ホウ)『バウ
胖	(ハン)〜(ゆたか)(なお)(ひろ)
抛	{拋}抛。(ホウ)〜(なげう・つ)『ハウ
拋	{拋}抛。なげうつ『ハウ『ホウ
萢	(ヤチ)(ヤラ)
刨	{刨}鉋。かんな
垉	(ホウ)
咆	(ホウ)〜(ほ・える)
庖	(ホウ)〜(くりや)『ハウ
袍	(ホウ)〜(わたいれ)『ハウ
匏	(ホ)(ホウ)〜(ひさご)『ふくべ
蚫	(ホウ)〜(あわび)
鞄	(ハク)(ホウ)(ビョウ)〜(かばん)
泡	(ホウ)〜(あわ)『あぶく『ハウ
炮	{炮}砲。(ホウ)〜(あぶ・る)『ハウ
砲	{炮}砲。(ホウ)〜(づつ)『ハウ
疱	(ホウ)〜(もがさ)『ハウ
皰	(ホウ)(ビョウ)〜(にきび)
麭	(ホウ)〜(こなもち)
胚	(ハイ)〜(はらみ)(はら・む)
陪	(バイ)
培	(バイ)〜(つちか・う)
裴	(ハイ)(ヒ)(ベ)〜(たちもとお・る)
賠	(バイ)『つぐなう
沛	(ハイ)
帔	むし『むしのたれぎぬ
佩	(ハイ)〜(は・く)(お・びる)(おびだま)
珮	(ハイ)〜(おびだま)
配	(ハイ)〜(くば・る)
旆	(ハイ)〜(はた)
霈	(ハイ)〜(ひさめ)
轡	(ヒ)〜(くつわ)(たづな)
轡銜	くつばみ
噴	(フン)〜(ふ・く)
濆	(フン)(ホン)〜(ほとり)(わ・く)
盆	(ボン)『ぼに
怦	(ホウ)(ヒョウ)
烹	(ホウ)〜(に・る)『ハウ
弸	(ホウ)
朋	(ホウ)〜(とも)
堋	(ホウ)
彭	(ホウ)
棚	(ホウ)〜(たな)(だな)『たな
蓬	(ホウ)(ブ)〜(よもぎ)
硼	(ホウ)『ハウ
澎	(ホウ)(ヒョウ)
篷	(ホウ)〜(とま)
膨	(ボウ)〜(ふく・らむ)(ふく・れる)『バウ
鵬	(ホウ)〜(おおとり)
捧	(ホウ)〜(ささ・げる)
椪	(ポン)
碰	ポン
丕	(ヒ)〜(おお・きい)
批	(ヒ)
披	(ヒ)『ひらく
砒	(ヒ)(ヘイ)
紕	(ヒ)
劈	(ヘキ)(ヒャク)〜(つんざ・く)(さく)
霹	(ヘキ)(ヒャク)
皮	(ヒ)〜(かわ)(けがわ)『かは
枇	(ビ)(ヒ)
毘	(ヒ)(ビ)〜(たす・ける)
疲	(ヒ)〜(つか・れる)(づか・れ)(つか・らす)
豼	(ヒ)
琵	(ビ)(ヒ)
脾	(ヒ)
鈹	かは『かわ
貔	(ヒ)
羆	(ヒ)〜(ひぐま)(しぐま)『しくま
匹	(ヒツ)〜(ひき)『き『びき『ぴき『むら
痞	(ヒ)〜(つかえ)
癖	(ヘキ)〜(くせ)(くせ・に)
屁	(ヒ)〜(へ)(おなら)
睥	(ヘイ)〜(ながしめ)(み・る)
辟	{辟}闢。(ヘキ)(ヒ)〜(きみ)(ひら・く)(め・す)『ビャク
僻	(ヘキ)(ヒ)(ヘイ)〜(へき・する)(ひが・む)『ひが
甓	(ヘキ)(ビャク)〜(かわら)
譬	(ヒ)〜(たと・える)(たと・え)
闢	{辟}闢。(ヘキ)(ビャク)〜(ひら・く)
偏	(ヘン)〜(かたよ・る)『かたほ『ひとえに
篇	(ヘン)『ぺん
翩	(ヘン)〜(ひるが・える)
胼	(ヘン)
胼胝	たこ
諚	(ジョウ)『ヂヤウ
駢	(ヘン)〜(なら・ぶ)
諞	(ヘン)
片	(ヘン)〜(かた)(かた)『ひら『びら『ぺん『ペンス
片方	かたえ『へ
片秀	かたほ
騙	(ヘン)〜(かた・る)(だま・す)
剽	(ヒョウ)〜(おびや・かす)(さす)『ヘウ
漂	(ヒョウ)〜(ただよ・う)『ヘウ
縹	(ヒョウ)〜(はなだ)(はなだ・いろ)
飄	(ヒョウ)〜(ひるが・える)(つむじかぜ)『つむじ『ヘウ
飃	(ヒョウ)〜(ひるが・える)(つむじかぜ)
嫖	(ヒョウ)〜(かる・い)
瓢	(ヒョウ)〜(ひさご)(ふくべ)『ヘウ
殍	(ヒョウ)(フ)〜(うえじに)
票	(ヒョウ)『びょう『ぴょう『ヘウ『ベウ『ペウ
慓	(ヒョウ)
暼	(ヘツ)(ヘチ)
瞥	(ベツ)(ヘツ)
丿	(ヘツ)(ノ)〜(えい)(よう)(の)(のかんむり)
貧	(ヒン)(ビン)〜(まず・しい)
頻	〔頻〕頻。(ヒン)〜(しき・りに)『しき『しきり『しきる
嬪	(ヒン)〜(ひめ)
嚬	{顰}嚬。ひん
顰	{顰}嚬。(ヒン)〜(ひそ・める)(しか・める)
品	(ヒン)(ホン)〜(しな)『ぴん『ぼん『ぽん
牝	(ヒン)〜(めす)(め)(めん)
聘	(ヘイ)〜(へい・する)(と・う)(め・す)
娉	(ヘイ)(ホウ)〜(ほ)
冖	(ベキ)〜(わかんむり)(べきかんむり)
平	(ヘイ)(ビョウ)(ヒョウ)〜(たい・ら)(だいら)(ひら)(ひら)(たいら)(たら)(はち)(ひ)(ひとし)(へ)(へん)『たひら『ヒャウ『ヒヤウ『ビャウ
坪	(ヘイ)〜(つぼ)『つぼ
苹	(ヘイ)(ビョウ)(ホウ)〜(ほ)
岼	(ゆり)
凭	(ヒョウ)(ヘイ)〜(もた・れる)(よ・る)
泙	(ホウ)
屏	(ヘイ)(ビョウ)〜(おお・う)(しりぞ・く)(びょう・ぶ)『ビャウ
瓶	〔甁〕瓶。(ビン)〜(かめ)(へい)(べ)(ぺ)『ビャウ『ビョウ
萍	(ヘイ)(ヒョウ)〜(うきくさ)
塀	〔塀〕塀。(ヘイ)(ベイ)
甁	〔甁〕瓶。ビン
評	(ヒョウ)『ヒャウ『ヒヤウ
鮃	(ヒョウ)(ヘイ)〜(ひらめ)
憑	(ヒョウ)〜(つ・く)(つか・れる)(よ・る)(たの・む)
蘋	(ヒン)〜(うきくさ)
攴	(ホク)〜(ぼくづくり)(ぼくにょう)(とまた)
坡	(ハ)(ヒ)〜(つつ・み)
溌	(ハツ)〜(も・る)(とびち・る)(そそ・ぐ)
醱	{醱}醗。ハツ
婆	(バ)〜(ばば)(ばあ)『ばばあ『ホṬ
岶	(ハク)
迫	(ハク)〜(せま・る)(さこ)(せ)(せこ)(はさ)(はさま)(はざま)
珀	(ハク)
破	(ハ)〜(やぶ・る)(やぶ・れる)(わ)『われる
破り籠	わりご
破り子	わりご
粕	(ハク)〜(かす)
魄	(ハク)(タク)〜(たま・しい)『たま『だましい『たましひ『だましひ
頗	(ハ)〜(すこぶ・る)(かたよ・る)
剖	(ボウ)『ホウ
抔	(ホウ)(ハイ)〜(など)(すく・う)
撲	(ボク)『うつ『なぐる
鋪	{鋪}舗。(ホ)(フ)〜(しく)(みせ)(しき)『ぽ
鯆	(フ)(ホ)〜(いるか)
仆	(フ)〜(たお・れる)
匍	(ホ)〜(は・う)
菩	(ボ)
脯	(フ)(ホ)〜(こじし)(ほじし)『ほしし
葡	(ブ)(ホ)
蒲	(ホ)(ボ)(フ)(ブ)〜(がま)(かば)(かま)
僕	(ボク)〜(しもべ)『やつがれ
璞	(ハク)〜(あらたま)
濮	(ボク)(ホク)
朴	{朴}樸。(ボク)〜(ほう)(ほお)『えのき『ほほ
埔	(ホ)
圃	(ホ)(フ)〜(はたけ)(にわ)
浦	(ホ)〜(うら)『うら
普	(フ)〜(あまね・く)(あまねし)(しん)(ひろ)
溥	(フ)(ハク)〜(あまねし)
樸	{朴}樸。(ボク)(ハク)(ホク)〜(こはだ)(きじ)
蹼	(ボク)(ホク)〜(みずかき)『みづ
譜	(フ)
舖	(ホ)
舗	{鋪}舗。(ホ)〜(き)『しく『ぽ
瀑	(バク)(ハク)(ホウ)(ボウ)(ホク)(ボク)〜(たき)(にわかあめ)
曝	(バク)(ホク)(ボク)〜(さら・す)
七	(シチ)〜(なな)(なな・つ)(なの)(し)(しっ)(な)(ひち)『シツ『チー
七五三	しめ
妻	(サイ)〜(つま)(ずま)(め)
栖	{棲}栖。(セイ)〜(す・む)(す)(すみ)『すみか
凄	{淒}凄。(セイ)(サイ)〜(さむ・い)(すご・い)(すさ・まじい)
萋	(セイ)(サイ)
戚	(ソク)(セキ)〜(いた・む)(うれ・える)(みうち)
淒	{淒}凄。(セイ)(サイ)〜(すご・む)(さむ・い)(すご・い)(すさ・まじい)
悽	{淒}悽。(セイ)〜(いたむ)
朞	(キ)(ゴ)
期	(キ)(ゴ)
欺	(ギ)〜(あざむ・く)
棲	{棲}栖。(セイ)〜(す・む)(ずみ)『す『すみか
棲（み）家	すみか
褄	(つま)
榿	(ガイ)(カイ)
漆	(シツ)〜(うるし)(うる)『シチ
漆樹	うるし
蹊	(ケイ)〜(みち)(わた・る)
祁	(キ)(ケ)
圻	(キ)(ギン)〜(さか・い)
岐	(キ)(ギ)〜(たかし)(また)『ちまた『わかれる
其	(キ)(ギ)(ゴ)〜(そ・れ)(そ・の)『し『そ
奇	(キ)〜(く・しき)(あや・しい)(くし)(めずら・しい)『あなしい『あやに『くすし
斉	{齊}斉。(セイ)(サイ)〜(そろ・う)(ひと・しい)(ひと・しく)(あたる)(はやい)(ただ)(なり)(ひと)(ひとし)『ととのう『ととのえる
祈	〔祈〕祈。(キ)〜(いの・る)(のり)(れい)
祇	(ギ)(キ)(シ)〜(くにつかみ)(ただ)(まさに)
竒	(キ)〜(く・しき)(あや・しい)(くし・くも)(めずら・しい)
耆	(キ)(シ)〜(おい・る)
埼	(キ)〜(さき)(さい)(みさき)
畦	(ケイ)〜(あぜ)(うね)『くろ
跂	(キ)〜(つまだ・つ)(むつゆび)
崎	(キ)〜(さき)(さい)(みさき)『さき
淇	(キ)
棊	{棋}棊。(キ)〜(ご)
棋	{棋}棊。(キ)〜(ご)
嵜	(キ)〜(さき)(さい)(みさき)
祺	(キ)〜(さいわ・い)
碁	{棋}碁。(ゴ)『キ
碕	(キ)〜(さき)(さい)(みさき)
齊	{齊}斉。(セイ)(サイ)〜(そろ・う)(ひと・しい)(ひと・しく)(あたる)(はやい)(ひとし)『ととのう『ととのえる
旗	(キ)〜(はた)
緕	(かすり)
鮨	(シ)(キ)〜(すし)
騏	(キ)
騎	(キ)
臍	(セイ)(サイ)〜(へそ)(ほぞ)
麒	(キ)
籏	(キ)〜(はた)
纃	(かすり)
鰭	(キ)(ギ)〜(ひれ)『はた
乞	(コツ)(キツ)(キ)(キケ)(コチ)〜(こ・う)『こう
乞丐	かったい『ゐ
企	(キ)〜(くわだ・てる)
杞	(コ)(キ)
起	(キ)〜(お・きる)(お・こる)(お・こす)(おこ・す)(た・つ)
豈	(カイ)(ガイ)(キ)〜(あに)
啟	{啟}啓。ケイ『ひらく『もうす
啓	{啟}啓。(ケイ)〜(ひら・く)(さと・す)(あき)(あきら)(さとし)(はじめ)(ひろ)(よし)『もうす
綮	(ケイ)
綺	(キ)〜(あや)『かんはた
气	(キ)(ケ)〜(いき)(きがまえ)
気	{氣}気。(キ)(ケ)〜(いき)『ぎ『げ
迄	(キツ)〜(まで)(およ・ぶ)
弃	(キ)〜(すて・る)
汽	(キ)
泣	(キュウ)〜(な・く)『キフ
契	(ケイ)〜(ちぎ・る)『せつ
砌	(サイ)(セイ)〜(みぎり)『みぎん
氣	{氣}気。(キ)(ケ)〜(いき)『ぎ『げ
訖	(キツ)〜(お・える)(お・わる)(ついに)
葺	(シュウ)〜(あし)(ふ・く)(ふき)
棄	(キ)〜(す・てる)
槭	(セキ)(シュク)〜(かえで)
槭樹	かえで『かへで
噐	(キ)〜(うつわ)
憇	(ケイ)〜(いこ・い)(いこ・う)
磧	(セキ)〜(かわら)『かはら
器	〔器〕器。(キ)〜(うつわ)『うつは
憩	(ケイ)〜(いこ・い)(いこ・う)
薺	(セイ)(ザイ)〜(ひと)(ととの・える)(なずな)『なづな
峠	{卡}峠。(とうげ)『たうげ『とうげ
鞐	(こはぜ)
洽	(コウ)〜(あまねし)(うるお・す)
恰	(コウ)(カッ)(チョウ)(キョウ)〜(あたか・も)『カフ
千	(セン)〜(ち)(かず)(ゆき)
仟	(セン)〜(ち)(かしら)
阡	(セン)
竏	(キロリットル)
粁	(キロメートル)
牽	(ケン)〜(ひ・く)
愆	(ケン)〜(あや・まる)
鉛	(エン)〜(なまり)
僉	(セン)〜(みな)
慳	(ケン)(カン)〜(おし・む)
搴	(ケン)〜(と・る)(ぬ・く)
遷	(セン)〜(うつ・る)(うつ・す)(みやこがえ)
謙	(ケン)〜(かね)『へりくだる
簽	(セン)〜(かご)
籤	(セン)〜(くじ)(かずとり)『ひご
韆	(セン)
瓩	(キログラム)
拑	(カン)(ケン)〜(つぐ・む)
前	(ゼン)〜(まえ)(まえ)(さき)(さと)(まい)『ぜ『セン『まへ
前兆	さが
虔	(ケン)〜(つつし・む)
乾	(カン)(ケン)〜(かわ・く)(かわ・かす)(ほ・す)(ひ・る)(いぬい)『ひ『ふ『ゐ
乾し飯	いひ『ほしいい
乾瘡	はたけ
乾飯	{乾飯}干飯。いひ『かれいい
乾肉	ほしし
鉗	{鉗}箝。(ケン)(カン)〜(つぐ・む)(くびかせ)『はさむ
箝	{鉗}箝。(カン)(ケン)〜(す・げる)(くびかせ)(はさ・む)
銭	{錢}銭。(セン)(ゼン)〜(ぜに)(すき)『ぜぜ『ちゃん
蕁	(ジン)(タン)
潜	〔潛〕潜。(セン)〜(ひそ・む)(もぐ・る)(かく・れる)(くぐ・る)(ひそ・める)『かずく『ひそかに
潛	〔潛〕潜。(セン)〜(ひそ・む)(もぐ・る)(かく・れる)(くぐ・る)(ひそ・める)『かずく『ひそかに
黔	(ケン)(キン)〜(くろ・い)
錢	{錢}銭。(セン)〜(ぜに)(すき)『ぜぜ『ちゃん
濳	(セン)〜(ひそ・む)(もぐ・る)(かく・れる)(くぐ・る)(ひそ・める)
籖	(セン)〜(くじ)(かずとり)
凵	(カン)〜(うけばこ)(かんにょう)
浅	〔淺〕浅。(セン)〜(あさ・い)(あざ)(さ)
浅甕	さらけ
淺	〔淺〕浅。(セン)〜(あさ・い)
遣	(ケン)〜(つか・う)(つか・い)(づか・い)(つか・わす)(や・る)『しむ『よこす
譴	(ケン)〜(せめ・る)
鑓	(やり)
欠	〔缺〕欠。(ケツ)(ケン)〜(か・ける)(か・く)(あくび)『かん
欠伸	あくび
刋	(カン)(セン)〜(き・る)(けず・る)
茜	(セン)〜(あかね)
倩	(セン)(セイ)〜(つらつら)(うつく・しい)
嵌	(カン)〜(は・める)(は・まる)(あな)
慊	(ケン)(キョウ)〜(あきたりる)(うら・む)
塹	(ザン)(セン)〜(ほり)(あな)『ほりき
歉	(ケン)(カン)〜(あきたりない)
槧	(ザン)(セン)(サン)〜(ふだ)
篏	(カン)〜(は・める)(は・まる)(あな)
壍	ほりき
羌	(キョウ)〜(ああ)(えびす)『キヤウ
羗	きょん
啌	(クウ)(コウ)
椌	(コウ)
腔	(コウ)『カウ『クウ
槍	(ソウ)(ショウ)〜(やり)(うつ)『サウ
槍鉋	やりがんな
錆	(ショウ)(セイ)〜(さび)(くわ・しい)
鎗	(ソウ)(ショウ)〜(やり)
鏘	(ソウ)(ショウ)
強	(キョウ)(ゴウ)〜(つよ・い)(つよ・まる)(つよ・める)(し・いる)(こわ・い)(すね)『あながち『ガウ『キャウ『キヤウ『しいて『したたか『つとめる
墻	(ショウ)〜(かき)
薔	(バ)(ショウ)(ショク)(ソウ)〜(みずたで)
檣	(ショウ)〜(ほばしら)『シャウ
牆	(ショウ)〜(かき)『シャウ
艢	(ロ)(ショウ)(ゾウ)〜(とも)(ほばしら)
搶	(ソウ)(ショウ)〜(つ・く)
襁	(キョウ)〜(むつき)
繦	(キョウ)〜(むつき)(ぜにさし)
蹌	(ソウ)(ショウ)〜(うご・く)(よろ・めく)
悄	(ショウ)〜(うれ・える)『しおれる『セウ
敲	(コウ)〜(たた・く)(のぼる)『カウ
橇	(キョウ)(ゼイ)(セイ)〜(そり)(かんじき)
磽	(コウ)(キョウ)
鍬	(ショウ)(シュウ)〜(くわ)(すき)『くは
喬	(キョウ)〜(たか・い)(たかし)(たか)『ケウ
僑	(キョウ)〜(きゅう)『ケウ
蕎	(キョウ)〜(そば)
憔	(ショウ)(セウ)(ソウ)〜(やつ・れる)(やせ・る)
橋	(キョウ)〜(はし)(ばせ)『ケウ
樵	(ショウ)〜(きこ・る)(こ・る)(きこり)『セウ
巧	(コウ)〜(たく・み)(たく・む)(うま・い)(かつ)(たくみ)(よし)『カウ
巧み	たくみ
愀	(シュウ)(ショウ)
峭	(ショウ)〜(きび・しい)(けわ・しい)
殼	{殼}殻。(カク)(コク)(バイ)〜(から)『かい『かひ
誚	(ショウ)〜(せ・める)
鞘	(ショウ)(ソウ)〜(さや)
翹	(ギョウ)〜(あ・げる)(つまだ・てる)
竅	(キョウ)〜(あな)『ケウ
切	(セツ)(サイ)〜(き・る)(き・る)(き・り)(き・り)(ぎ・り)(き・れる)(き・れる)(き・れ)(き・れ)(ぎ・れ)(きつ)(きり)(ぎり)『せち
切っ先	きっさき
苆	すさ『つた
茄	(カ)『なす『なすび
茄子	なす『なすび
且	(ショ)(ソ)(ショウ)〜(か・つ)(あき)(かつ)『かつ『しばらく『シャ
妾	(ショウ)〜(めかけ)(そばめ)(わらわ)『セフ『わらは
怯	(キョウ)(コウ)〜(ひる・む)(おびえ・る)(おじる)(おび・える)(おそ・れる)『ケフ
窃	〔竊〕窃。(セツ)〜(ぬす・む)(ひそ・か)『ひそかに
挈	(ケイ)(ケツ)〜(ひっさ・げる)
篋	(キョウ)〜(はこ)
竊	〔竊〕窃。(セツ)〜(ぬす・む)(ひそ・かに)
侵	(シン)〜(おか・す)
衾	(キン)〜(ふすま)
駸	(シン)
芹	(キン)〜(せり)(せい)(よし)
秦	(シン)〜(はた)(たい)(はだ)(やす)『はたしん
琴	(キン)〜(こと)『ゴン
禽	(キン)〜(とり)(とりこ)
勤	〔勤〕勤。(キン)(ゴン)〜(つと・める)(づと・め)(つと・まる)(いそ・しむ)
擒	(キン)〜(とら・える)(とりこ)
檎	(キン)(ゴン)(ゴ)
懃	(キン)(ゴン)〜(ねんごろ)
寝	{寢}寝。(シン)〜(ね・る)(ね・かす)(い・ぬ)(みたまや)(や・める)『い『ぬ『ね
寢	{寢}寝。(シン)〜(ね・る)(ね・かす)(い・ぬ)(みたまや)(や・める)『い『ぬ『ね
沁	(シン)〜(し・みる)
青	〔靑〕青。(セイ)(ショウ)〜(あお)(あお)(あお・い)(お)『あを『シャウ
靑	〔靑〕青。あお『あおい『ショウ『セイ
卿	(ケイ)(キョウ)〜(きみ)『かみ『キャウ『キヤウ『まえつきみ『まちぎみ『まへ
圊	かは『かわや
清	〔淸〕清。(セイ)(ショウ)(シン)〜(きよ・い)(きよ・まる)(きよ・める)(あき)(さや)(し)(すが)(すみ)(せ)(ちん)『さやか『シャウ『すがやか『すむ
淸	〔淸〕清。きよい『きよまる『きよめる『ショウ『セイ
軽	{輕}軽。(ケイ)〜(かる・い)(かろ・やか)(かろ・んじる)『かる『キャウ『キョウ『キンṬ
傾	(ケイ)〜(かたむ・く)(かたむ・ける)(かたぶ・く)(かた・げる)(かし・げる)
輕	{輕}軽。(ケイ)〜(かる・い)(かろ・やか)(かろ・んじる)『かる『キャウ『キョウ『キンṬ
蜻	(セイ)
鯖	(セイ)(ショウ)〜(さば)
勍	(ケイ)〜(つよ・い)
情	(ジョウ)(セイ)〜(なさ・け)『ジャウ『ジヤウ
晴	(セイ)〜(は・れる)(は・れ)(は・れ)(ば・れ)(は・らす)(はる)(はれ)
檠	(ケイ)〜(ゆだめ)
黥	(ケイ)(ゲイ)〜(いれずみ)
頃	(ケイ)(キョウ)〜(ころ)(ごろ)(しばら・く)(ころも)『このごろ『ころ
請	(セイ)(シン)(ショウ)〜(こ・う)(う・ける)(うけ)『シャウ『シヤウ
謦	(ケイ)〜(しわぶき)
慶	(ケイ)〜(よろこ・び)(き)(きよん)(け)(みち)(む)(やす)(よし)『キャウ『キョウ『よろこぶ
磬	(ケイ)『きん
親	(シン)〜(おや)(おや)(した・しい)(した・しむ)(ぎ)(ちか)(のり)『ちかい『みずから
穹	(キュウ)(キョウ)〜(あめ)(そら)
蛩	(キョウ)〜(こおろぎ)
蛬	(キョウ)〜(ころぎ)(きりぎりす)
跫	(キョウ)〜(あしおと)
煢	(ケイ)〜(ひとりもの)
窮	(キュウ)(キョウ)〜(きわ・める)(きわ・まる)(きわ・まり)(きわ・み)
瓊	(ケイ)〜(たま)『に『ぬ
丘	(キュウ)〜(おか)(たかし)『お『キウ『ク『つかさ『を『をか
邱	(キュウ)〜(おか)
秋	(シュウ)〜(あき)(とき)(あい)『シウ
蚯	(キュウ)〜(みみず)
萩	(シュウ)〜(はぎ)(は)
湫	(シュウ)(ショウ)〜(くて)『くで
楸	(シュウ)〜(きささげ)(ひさぎ)
穐	(シュウ)〜(あき)(とき)
鞦	(シュウ)〜(ふらん・に)(しりがい)『しりがき
鰍	{鰍}鰌。(シュウ)(シュ)〜(かじか)(いなだ)(どじょう)『どぢやう
鰌	{鰍}鰌。(シュ)(シュウ)〜(どじょう)『どぢやう
龝	(シュウ)〜(あき)(とき)
囚	(シュウ)〜(とら・われる)『シウ『とらえる
求	(キュウ)(グ)〜(もと・める)『キウ
虬	{虯}虬。づ『みずち
虯	{虯}虬。づ『みずち
泅	(シュウ)〜(およぐ)
酋	(シュウ)(ジュ)〜(おさ)(ふるざけ)(さけのつかさ)『シウ
逑	(キュウ)〜(つれあ・い)
逎	(シュウ)〜(せま・る)(つよ・い)
球	(キュウ)〜(たま)(く)『キウ
梂	いが『かさ
毬	(キュウ)〜(いが)(まり)『かさ『キウ
釻	つく
遒	(シュウ)〜(せま・る)(つよ・い)
裘	(キュウ)(グ)〜(かわごろも)『キウ
糗	はったい
区	{區}区。(ク)(オウ)(コウ)『まち
屈	(クツ)〜(かが・む)(かが・める)(くっ)『かがまる
區	{區}区。(ク)(オウ)(コウ)『まち
蛆	(ソ)(ショ)〜(うじ)
躯	{軀}躯。(ク)〜(むくろ)(からだ)
駆	〔驅〕駆。(ク)〜(か・ける)(か・る)
嶇	(ク)〜(けわ・しい)
麹	{麴}麹。(キク)〜(こうじ)『かうぢ
駈	(ク)〜(か・ける)(か・る)
髷	(キョク)〜(まげ)(わげ)
趨	(スウ)(ソク)〜(しゅ)(おもむ・く)(はし・る)
軀	{軀}躯。からだ『ク『むくろ
麴	{麴}麹。かうぢ『キク『こうじ
驅	〔驅〕駆。(ク)〜(か・ける)(か・る)
劬	(ク)〜(つか・れる)
渠	(キョ)〜(かれ)(なんぞ)(なに)(みぞ)(いずくんぞ)(だかり)
瞿	(ク)〜(おそ・れる)(み・る)
衢	(ク)〜(みち)『ちまた
曲	(キョク)〜(ま・がる)(ま・げる)(まがた)『くせ『くま『ごく『み『わ『わだ
取	(シュ)〜(と・る)(と・り)(と・り)(とり)(ど・り)(どる)
娶	(シュ)〜(めと・る)(めあわ・せる)
齲	(ク)(ウ)〜(むしば)
去	(キョ)(コ)〜(さ・る)(さ・る)(い)『いぬ
趣	(シュ)〜(おもむき)(おもむ・く)
闃	(ゲキ)(ケキ)〜(しずか)(ひっそり)
悛	(シュン)(セン)〜(あらた・める)
圈	{圈}圏。(ケン)〜(かこ・い)
圏	{圈}圏。(ケン)〜(かこ・い)
全	(ゼン)〜(まった・く)(すべ・て)(たけ)(まさ)『うつ『まっとうする
泉	(セン)〜(いずみ)(いず)(ずい)(ずみ)(ぜい)(ぜん)(の)『いづ『いづみ
拳	(ケン)(ゲン)〜(こぶし)
痊	(セン)
惓	(ケン)〜(うむ)
筌	(セン)〜(うけ)(うえ)『うへ
湶	(セン)〜(いずみ)(ぜに)
楾	(はんぞう)
詮	(セン)〜(せん・ずる)(かい)(あき・らか)(あき)『かひ
蜷	(ケン)〜(にな)『みな
蜷局	とぐろ
銓	(セン)〜(はか・る)
権	{權}権。(ケン)(ゴン)〜(おもり)(かり)(はか・る)『はかり『はかりごと
權	{權}権。(ケン)(ゴン)〜(おもり)(かり)(はか・る)『はかり『はかりごと
顴	(ケン)(カン)
犬	(ケン)〜(いぬ)(いぬ)
犬児	{犬兒}犬児。えのころ『ゑのこ
犬兒	{犬兒}犬児。えのころ『ゑのこ
犬子	えのころ『ゑのこ
綣	(ケン)
券	(ケン)
椦	(ケン)〜(まげもの)
勧	〔勸〕勧。(カン)(ケン)〜(すす・める)『クヮン
勸	〔勸〕勧。(カン)(ケン)〜(すす・める)『クヮン
缺	〔缺〕欠。(ケツ)(ケン)〜(か・ける)(か・く)
闕	(ケツ)〜(か・ける)『けち
却	{卻}却。(キャク)〜(かえ・って)(しりぞ・く)(しりぞ・ける)
卻	{卻}却。(キャク)〜(かえ・って)(しりぞ・く)(しりぞ・ける)
埆	(カク)〜(きそ・う)『そね
雀	(ジャク)(ジャン)(サク)(シャク)〜(すずめ)(ざく)
舃	くつ
塙	(カク)(コウ)〜(はなわ)(かた・い)(はな)『はなは
愨	(カク)〜(つつし・む)(まこと)
確	(カク)(コウ)〜(たし・か)(たし・かめる)
鵲	(シャク)(ジャク)〜(かささぎ)
逡	(シュン)〜(しりぞ・く)
裙	(クン)〜(もすそ)
羣	(グン)〜(む・れる)(むれ)(むら)(むら・がる)
群	(グン)〜(む・れる)(む・れ)(むら)(むら・がる)(ぐり)(ぐ)(こお)(こおり)(ごうり)
然	(ゼン)(ネン)〜(しか)(しか・り)(しか・し)(さ)『さる『しかも『しかるに
髯	(ゼン)〜(ひげ)
燃	(ネン)〜(も・える)(も・やす)(も・す)『ゼン
燃え杭	ぐひ『もえぐい
冉	(ゼン)(ネン)〜(あや・うい)
苒	(ゼン)
染	(セン)〜(そ・める)(ぞ・め)(ぞめ)(そ・まる)(し・みる)(じ・みる)(し・み)(し・める)(そめ)『ゼン
穣	〔穰〕穣。(ジョウ)〜(わら)(ゆたか)(しげ)(みのる)『ジャウ
孃	{娘}孃。(ジョウ)〜(むすめ)『ヂャウ
禳	(ジョウ)〜(はら・う)
穰	〔穰〕穣。(ジョウ)〜(わら)(ゆたか)(みのる)『ジャウ
壌	〔壤〕壌。(ジョウ)〜(つち)『ジャウ
壤	〔壤〕壌。(ジョウ)〜(つち)『ジャウ
攘	(ジョウ)〜(ぬす・む)(はら・う)『ジャウ
譲	〔讓〕譲。(ジョウ)〜(ゆず・る)(ゆずり)『ジャウ
讓	〔讓〕譲。(ジョウ)〜(ゆず・る)『ジャウ
橈	(ドウ)(ジョウ)(ニョウ)〜(かい)(かじ)(たわ・む)(たわ・める)
饒	(ジョウ)(ニョウ)〜(ゆたか)(ぬう)(の)(よ)『ゼウ『ネウ
擾	(ジョウ)〜(みだ・れる)(みだ・す)(わずら・わしい)『ゼウ
遶	(ニョウ)(ジョウ)〜(めぐ・る)
蟯	(ギョウ)(ジョウ)
繞	(ジョウ)(ニョウ)〜(めぐ・る)(まわ・る)(もとう・る)(まとう)『ゼウ『ネウ
惹	(ジャク)(ジャ)〜(ひ・く)
熱	(ネツ)〜(あつ・い)(あた)
人	(ジン)(ニン)〜(ひと)(り)(と)(じ)(と)(ね)(ひこ)(ふみ)『たり
人城	ひとき
壬	(ニン)(ジン)(イ)〜(みずのえ)『みづ
仁	(ジン)(ニ)(ニン)〜(きみ)(く)(さと)(しのぶ)(じ)(と)(のり)(ひと)(ひとし)(ひろ)(まさ)(まさし)(やす)(よし)
忍	(ニン)〜(しの・ぶ)(しの・ばせる)(おし)
荏	(ジン)(ニン)〜(え)
荵	(ニン)(ジン)〜(しのぶ)
棯	(ネン)
稔	(ネン)(ジン)(ニン)〜(みの・る)(みのり)(とし)(なる)(なり)(みのる)(ね)(み)
綛	(かせ)(かすり)
刃	(ジン)(ニン)〜(は)(やいば)(き・る)(ち)(と)
刄	(ジン)(ニン)〜(は)(やいば)(き・る)
仞	(ジン)〜(はか・る)
仭	(ジン)〜(はか・る)
扨	(サ)〜(さて)(さ・す)
任	(ニン)〜(まか・せる)(まか・す)(さ)(とう)(ひで)『ジン『まき『まけ『まま
妊	(ニン)(ジン)〜(はら・む)(みごも・る)
衽	{衽}袵。(ジン)(ニン)〜(こくび)(おくみ)(しとね)『おおくび『おくび『おほ
姙	(ニン)(ジン)〜(はら・む)(みごも・る)
袵	{衽}袵。(ジン)(ニン)〜(こくび)(おくみ)(しとね)『おくび
靭	{韌}靭。(ジン)(ニン)(サ)(サイ)(サツ)〜(うつぼ)(しな・やか)(ゆぎ)(ゆき)
靱	{韌}靱。(ジン)(ニン)(サ)(サイ)(サツ)〜(うつぼ)(うつお)(しな・やか)(ゆぎ)『ゆき
韌	{韌}靭。ジン『ゆき
認	(ニン)〜(みと・める)(したた・める)
仍	(ジョウ)(ニョウ)〜(よ・って)(しきりに)(なお)(よる)
日	(ニチ)(ジツ)〜(ひ)(び)(か)(あ)(あき)(いる)(く)(くさ)(こう)(す)(たち)(に)(にっ)(につ)(へ)『け
戎	(ジュウ)〜(えびす)(つわもの)(えび)
茸	(ジョウ)(ニュ)〜(きのこ)(たけ)(しげ・る)『くさびら
栄	{榮}栄。(エイ)(ヨウ)〜(さか・える)(は・え)(ば・え)(は・える)(え)(さかえ)(しげ)(てる)(なが)(ひで)(よし)『ヤウ
容	(ヨウ)〜(い・れる)(かた)(ひろ)(まさ)『かたち『ゆるす
絨	(ジュウ)
蓉	(ヨウ)〜(はす)(よ)
溶	(ヨウ)〜(と・ける)(と・かす)(と・く)
榕	(ヨウ)〜(あこう)
榮	{榮}栄。(エイ)(ヨウ)〜(さか・える)(は・える)(え)『さかえ『はえ『ヤウ
熔	(ヨウ)〜(と・ける)(と・かす)(いがた)
融	(ユウ)〜(と・ける)(と・かす)(あきら)『とおる『とほる
鎔	(ヨウ)〜(と・ける)(と・かす)(いがた)(よん)
蠑	(エイ)
冗	(ジョウ)
穃	(ヨウ)
柔	(ジュウ)(ニュウ)〜(やわ・らか)(やわ・らかい)(やわ)(やわ・ら)(とお)『ジウ『ニウ『にこ『やは
揉	(ジュウ)〜(も・む)(も・める)
糅	(ジュウ)〜(ま・じる)『かて
蹂	(ジュウ)〜(ふ・む)『ジウ
鞣	(ジュウ)(ニュウ)〜(なめ・す)(なめしがわ)『なめし
肉	{肉}宍。(ニク)『しし
肉醤	{肉醬}肉醤。ししびしお『びしほ
肉醬	{肉醬}肉醤。ししびしお『びしほ
宍	{肉}宍。(ニク)(ジク)〜(しし)(し)(しん)
如	(ジョ)(ニョ)〜(ごと・し)(き)(ね)(ゆき)(よし)『ごと『しく『もころ『もし
茹	(ジョ)(ニョ)〜(ゆ・でる)(う・でる)
袽	のみ
儒	(ジュ)
濡	(ジュ)(ニュ)〜(ぬれ・る)(ぬら・す)(ぬ・れる)(ぬ・らす)(うるお・い)(うるお・う)(うるお・す)
孺	(ジュ)〜(おさない)(ちのみご)
嬬	(ジュ)〜(よわ・い)(つま)
臑	(ジ)(ドウ)(ジュ)(デイ)〜(すね)
襦	(ジュ)〜(したぎ)(はだぎ)
蠕	(ゼン)(ダ)(ネン)(ジュ)(ニュ)〜(うごめ・く)
繻	(シュ)〜(うすぎぬ)
汝	(ジョ)〜(なんじ)(なれ)『い『いまし『うぬ『し『しゃ『な『なむち『まし『みまし『んぢ
乳	(ニュウ)〜(ちち)(ち)
乳母	めのと
辱	(ジョク)〜(はずかし・める)『かたじけない『かたじけなくする『ニク『はじ『はじる『はぢ
入	(ニュウ)(ジュ)〜(い・る)(い・る)(い・り)(い・れる)(い・れ)(はい・る)(いり)(いる)(に)(の)(りり)『しお『ジフ『しほ『ジュウ『ニフ
杁	(イリ)
洳	(ジュ)
蓐	(ジョク)(ニク)〜(しとね)『しきね
鳰	(にお)『にほ
溽	(ヒョク)(ジョク)〜(むしあつ・い)
褥	(ジョク)〜(しとね)『にく
縟	(ジョク)〜(しげし)
阮	(ゲン)
軟	(ナン)〜(やわ・らか)(やわ・らかい)
桵	たら
蕋	(ズイ)〜(しべ)
蕊	{蕊}蘂。(ズイ)〜(しべ)
蘂	{蕊}蘂。(ズイ)〜(しべ)
枘	ほぞ
蚋	(ゼイ)(ネイ)(ゼツ)(ネチ)〜(ぶゆ)(ぶよ)(ぶと)(か)
瑞	(ズイ)(スイ)〜(みず)(しるし)(たま)(ず)(みつ)『みづ
睿	{睿}叡。(エイ)〜(あき・らか)
銳	{銳}鋭。エイ『するど『するどい『と
鋭	{銳}鋭。(エイ)〜(するど・い)(とし)『するど『と
叡	{睿}叡。(エイ)〜(あき・らか)
閏	(ジュン)〜(うるう)『うるふ
閠	(ケイ)(ギョク)(ケイ)(ジュン)〜(うるう)
潤	(ジュン)〜(うるお・う)(うるお・す)(うる・む)(めぐみ)
若	(ジャク)(ニャク)(ニャ)〜(わか・い)(わか)(も・しくわ)(も・し)(も・しくは)(わく)(わこ)『ごとし『もころ
若鷺	わかさぎ
弱	(ジャク)〜(よわ・い)(よわ・る)(よわ・まる)(よわ・める)『ニャク『わかい
楉	すはえ『すわえ
蒻	(ジャク)(ニャク)
嵶	(たお・やか)(たわ・む)
鰯	(いわし)
鶸	(ジャク)〜(ひわ)『ひは
洒	{灑}洒。(シャ)(ソン)(サイ)(セン)(セイ)〜(すす・ぐ)(あら・う)『そそぐ
撒	(サン)(サツ)〜(ま・く)
灑	{灑}洒。(シャ)(サイ)(サ)(セ)〜(そそ・ぐ)『すすぐ
卅	(ソウ)〜(さんじゅう)
颯	(サツ)(ソウ)〜(さっ・と)
薩	(サツ)(サチ)〜(さっ)
腮	{腮}顋。(サイ)〜(あご)(えら)
塞	(ソク)(サイ)〜(ふさ・ぐ)(とりで)(み・ちる)『ふさがる
顋	{腮}顋。(サイ)〜(あご)(えら)
鰓	(サイ)(シ)〜(えら)『あぎと
賽	(サイ)
三	(サン)(ゾウ)〜(み)(み・つ)(みっ・つ)(か)(さ)(さい)(さえ)(さぶ)(ざ)(ざえ)(ざぶ)(そう)(ぞ)(ただ)(みつ)(みん)(も)(や)
彡	(サン)(セン)〜(さんづくり)(かみかざり)
傘	(サン)〜(かさ)『からかさ
糂	(ジン)
糝	うづ『こなかき『みそうず
繖	(サン)
散	(サン)〜(ち・る)(ち・らす)(ち・らす)(ち・らかす)(ち・らかる)(ばら)(ちる)
桑	(ソウ)〜(くわ)(こ)『くは『サウ
喪	(ソウ)〜(も)『うしなう『サウ
掻	{搔}掻。(ソウ)〜(か・く)『サウ
搔	{搔}掻。かく『サウ『ソウ
懆	(ソウ)
騒	{騷}騒。(ソウ)〜(さわ・ぐ)(うれい)(さわ・がしい)『サウ
騷	{騷}騒。(ソウ)〜(さわ・ぐ)(うれい)(さわが・しい)『サウ
掃	(ソウ)(シュ)〜(は・く)(か)『サウ『はらう
嫂	(ソウ)〜(あによめ)
髞	(ソウ)〜(たかし)
色	(ショク)(シキ)〜(いろ)(しか)(しこ)
渋	{澀}渋。(ジュウ)(シュウ)〜(しぶ)(しぶ・い)(しぶ・る)『ジフ
瑟	(シツ)〜(おおごと)
嗇	(ショク)〜(やぶさ・か)(おし・む)
澁	{澀}澁。(ジュウ)(シュウ)〜(しぶ)(しぶ・い)(しぶ・る)『ジフ
澀	{澀}渋。(ジュウ)(シュウ)〜(しぶ)(しぶ・い)(しぶ・る)『ジフ
穡	(ショク)
森	(シン)〜(もり)(もと)
僧	〔僧〕僧。(ソウ)
沙	(サ)(シャ)〜(すな)(よなげる)『いさご
沙魚	はぜ
砂	(サ)(シャ)〜(すな)(いさ)(ご)『いさご
剎	{剎}刹。サツ『セツ
莎	(サ)(シャ)〜(はますげ)
殺	〔殺〕殺。(サツ)(サイ)(セツ)〜(ころ・す)(ごろ・し)(そ・ぐ)
殺	〔殺〕殺。ころす『サイ『サツ『セツ
紗	(サ)(シャ)〜(うすぎぬ)(たえ)(すず)
裟	(サ)(シャ)
魦	いさざ
鯊	(サ)(シャ)〜(さめ)(はぜ)
厦	(カ)(サ)〜(いえ)
歃	(ソウ)(コウ)(ショウ)〜(すす・る)
廈	(カ)(サ)〜(いえ)
霎	(ショウ)(ソウ)
篩	(シ)(サイ)〜(ふる・う)『ふるい『ふるひ
晒	(サイ)(シ)〜(さら・す)(さらし)
山	(サン)(セン)〜(やま)(さ)(やの)(やん)『むれ
山茶	つばき
山毛櫸	{山毛櫸}山毛欅。ぶな
山毛欅	{山毛櫸}山毛欅。ぶな
圸	(まま)
芟	(セン)(サン)〜(か・る)
杉	(サン)〜(すぎ)『すぎ
刪	(サン)〜(けず・る)
苫	(セン)〜(とま)
衫	(サン)
珊	(サン)〜(せんち)(さんち)
閊	(つか・える)
笘	(セン)(チョウ)
跚	(サン)
煽	(セン)〜(あお・る)(おだ・てる)(おこ・る)
潸	(サン)
穇	ひえ
羶	(セン)〜(なまぐさ・い)
陝	(セン)
閃	(セン)〜(ひらめ・く)(ひらめ・き)
汕	(サン)
疝	(セン)(サン)
扇	(セン)〜(おうぎ)(おう)(おおぎ)『あおぐ『あおる『あふぎ
善	(ゼン)〜(よ・い)(い・い)(よ・く)(よし・とする)(たる)(よし)『よくする
擅	(セン)〜(ほしいまま)『ほしきまま
膳	(ゼン)(セン)〜(かしわ)(すす・める)(そな・える)(ぜ)(よし)『かしは『かしわで
膳夫	かしは『かしわで
繕	(ゼン)〜(つくろ・う)
贍	(セン)〜(すく・う)
譱	(ゼン)〜(よ・い)(い・い)(よ・く)(よし・とする)
鱓	{鱔}鱓。うつぼ『ごまめ
鱔	{鱔}鱓。うつぼ『ごまめ
商	(ショウ)〜(あきな・う)(あき)『シャウ『シヤウ『はかる
傷	(ショウ)〜(きず)(いた・む)(いた・める)『シャウ
慯	(ショウ)
殤	(ショウ)〜(わかじに)
觴	(ショウ)〜(さかずき)
賞	(ショウ)〜(ほ・める)『シャウ『シヤウ『めでる
上	(ジョウ)(ショウ)(シャン)〜(うえ)(うえ)(うわ)(かみ)(あ・げる)(あ・げる)(あ・がる)(あ・がる)(あ・がり)(あ・がり)(のぼ・る)(のぼ・り)(のぼ・せる)(のぼ・す)(よ・す)(あおい)(あげ)(い)(か)(かき)(かず)(かん)(こう)(のぼり)(ほつ)『うは『うへ『え『かり『シャウ『ジャウ『ジヤウ『へ
上裳	うは『うわも
尚	(ショウ)〜(なお)(たか)(たかし)(ないし)(なり)(ひさ)(ひさし)『シャウ『たっとぶ『とうとぶ『なほ
裳	(ショウ)〜(も)(もすそ)『シャウ『チマ
梢	(ショウ)〜(こずえ)(くすのき)『ずゑ『セウ
稍	(ソウ)(ショウ)〜(やや)(ようやく)
焼	〔燒〕焼。(ショウ)〜(や・く)(や・き)(や・き)(や・き)(や・ける)(やい)(やき)『セウ
焼（き）米	やきごめ
蛸	(ソウ)(ショウ)〜(たこ)
燒	〔燒〕焼。(ショウ)〜(や・く)(や・ける)(やき)『セウ
鮹	(ショウ)(ソウ)〜(たこ)
勺	(シャク)『くむ『せき
芍	(シャク)
杓	(シャク)(チョウ)(テキ)(ヒョウ)〜(ひしゃく)『ひさく
韶	(ショウ)〜(つぐ)
少	(ショウ)〜(すく・ない)(すこ・し)『すない『セウ
邵	(ショウ)
劭	(ショウ)〜(つと・める)
哨	(ショウ)〜(みはり)『セウ
紹	(ショウ)〜(つぐ)『セウ
奢	(シャ)〜(おご・る)(おご・り)
舌	(ゼツ)〜(した)
蛇	(ジャ)(ダ)(イ)(ヤ)〜(へび)(あぶ)(み)『くちなわ『なは『へみ
舍	{舍}舎。(セキ)(シャ)〜(やど・る)(とね)『あらか『おく
舍屋	{舍屋}舎屋。やかす
捨	(シャ)〜(す・てる)
社	〔社〕社。(シャ)〜(やしろ)(こそ)
舎	{舍}舎。(シャ)(セキ)〜(やど・る)(さ)(とり)『あらか『おく
舎屋	{舍屋}舎屋。やかす
射	(シャ)〜(い・る)(さ・す)『うつ
涉	{涉}渉。ショウ『セフ『わたる
赦	(シャ)『ゆるす
設	(セツ)〜(もう・ける)(した)
渉	{涉}渉。(ショウ)〜(わた・る)(えん)『セフ
𦀌	のみ
摂	〔攝〕摂。(セツ)(ショウ)〜(おさ・める)(かね・る)(と・る)(せっ)『セフ
慴	(シュウ)(ショウ)〜(おそ・れる)
攝	〔攝〕摂。(セツ)(ショウ)〜(おさ・める)(かね・る)(と・る)『セフ
麝	(ジャ)(シャ)
懾	(ショウ)〜(おそ・れる)
申	(シン)〜(もう・す)(もう・し)(さる)『まう『もう
伸	(シン)〜(の・びる)(の・ばす)(の・べる)(の・す)(のぶ)(よぼる)
身	(シン)〜(み)『みずから『む『むくろ
身体	{身體}身体。からだ
身體	{身體}身体。からだ
呻	(シン)〜(うめ・く)(うめき)
娠	(シン)
深	(シン)〜(ふか・い)(ぶか・い)(ふか・まる)(ふか・める)(み)『ふけ
紳	(シン)〜(まこと)
罧	(リン)
蔘	(シン)(サン)
鯵	(ソウ)〜(あじ)
鰺	(ソウ)〜(あじ)『あぢ
什	(ジュウ)(シュウ)『ジフ
神	〔神〕神。(シン)(ジン)〜(かみ)(かん)(こう)(か)(かぐ)(かな)(かも)(くま)(こ)(こは)(だま)(み)『かむ
神籬	ひもろぎ
榊	(さかき)
鰰	(はたはた)
沈	(チン)(ジン)〜(しず・む)(しず・める)(しん)『ヂン
沈鳧	たかべ
哂	(シン)〜(わら・う)
矧	(シン)〜(は・ぐ)(いわ・んや)(はぐき)(はぎ)
審	(シン)〜(つまび・らか)(つぶさ・に)(あきら)
瀋	(シン)
甚	(ジン)〜(はなは・だ)(はなは・だしい)(じ)『いた
腎	(ジン)『むらと
椹	(ジン)(チン)(シン)〜(さわら)(あてぎ)(くわのみ)『さはら
蜃	(シン)
慎	〔愼〕慎。(シン)〜(つつし・む)(つつし)(つつし・み)(ちか)(のり)(まこと)(みつ)
愼	〔愼〕慎。(シン)〜(つつし・む)(つつし・み)
滲	(シン)〜(し・みる)(にじ・む)
升	{升}昇。(ショウ)〜(ます)(のぼる)
生	(セイ)(ショウ)〜(い・きる)(い・かす)(い・ける)(う・まれる)(う・まれ)(うまれ)(う・む)(お・う)(は・える)(は・やす)(き)(なま)(なま)(な・る)(な・す)(む・す)(う)(あさ)(いき)(いく)(いけ)(うぶ)(うまい)(え)(おい)(ぎゅう)(くるみ)(ごせ)(さ)(じょう)(すぎ)(そ)(そう)(ちる)(なば)(にう)(にゅう)(ふ)(み)(もう)(よい)(りゅう)『シャウ『シヤウ
生姜	{生薑}生姜。シヤウ『しょうが
生薑	{生薑}生姜。シヤウ『しょうが
生血	のり
声	{聲}声。(セイ)(ショウ)〜(こえ)(こわ)『こゑ『シャウ『シヤウ
枡	(ます)
昇	{升}昇。(ショウ)〜(のぼ・る)(しゅう)(のり)
牲	(セイ)『にえ『にへ
陞	{升}陞。(ショウ)〜(のぼ・る)
笙	(ショウ)(ソウ)〜(ふえ)『サウ『シャウ『シヤウ
甥	(セイ)(ソウ)(ショウ)〜(おい)(むこ)『をひ
聲	{聲}声。(セイ)(ショウ)〜(こえ)(こわ)『こゑ『シャウ『シヤウ
縄	{繩}縄。(ジョウ)〜(なわ)(ただ・す)『なは
繩	{繩}縄。(ジョウ)〜(なわ)(ただ・す)『なは
省	(セイ)(ショウ)〜(かえり・みる)(はぶ・く)(さとし)(み)『シャウ『シヤウ
晟	(セイ)(ジョウ)〜(あきらか)
盛	(セイ)(ジョウ)〜(も・る)(さか・る)(さか・ん)(もり)『ジャウ
剰	〔剩〕剰。(ジョウ)〜(あまつさえ)(あま・り)(あま・る)
剩	〔剩〕剰。(ジョウ)〜(あまつさえ)(あま・り)(あま・る)
勝	(ショウ)〜(か・つ)(が・ち)(まさ・る)(すぐ・れる)(かつ)(かち)(と)(よし)『たえる
聖	(セイ)(ショウ)〜(ひじり)(きよ)(さと)(さとし)(せ)(たか)(ただ)(ひろ)(まさ)(み)『シャウ『シンṬ
尸	(シ)〜(かたしろ)(しかばね)(しかばねかんむり)『かばね
失	(シツ)〜(うしな・う)(う・せる)
虱	(シツ)〜(しらみ)
施	(シ)(セ)〜(ほどこ・す)
屍	(シ)〜(しかばね)『かばね
師	(シ)〜(のし)(のり)(もろ)
絁	あしぎぬ
葹	(シ)〜(おなもみ)
湿	{濕}湿。(シツ)(シュウ)〜(しめ・る)(しめ・す)(うるお・う)(うるお・す)『しとる
蓍	(シ)〜(めどぎ)『めど
獅	(シ)〜(しし)
詩	(シ)〜(うた)
蝨	(シツ)〜(しらみ)
濕	{濕}湿。(シツ)(シュウ)〜(しめ・る)(しめ・す)(うるお・う)(うるお・す)『しとる
鰤	(シ)(ソウ)〜(ぶり)(はまち)(かます)
十	(ジュウ)(ジッ)(ジュッ)〜(とお)(と)(い)(か)(ぎ)(さ)(し)(そ)(そう)(ち)(とう)(ね)(ま)(る)(わ)『シー『ジフ『つづ『とを
辻	(つじ)『つむじ
石	(セキ)(シャク)(コク)〜(いし)(いさ)(いす)(いわ)(し)(せっく)(と)
石斑魚	うぐい『うぐひ
石伏魚	ごり
石決明	あはび『あわび
石蕗	つは『つわぶき
瓧	(デカグラム)
竍	(デカリットル)
実	{實}実。(ジツ)(シツ)〜(み)(みの・る)(まこと)(まことに)(みの)(みち・る)(ぐみ)(さね)『ざね『じち『まめ『むざね
拾	(シュウ)(ジュウ)〜(ひろ・う)『シフ『ジフ
食	(ショク)(ジキ)〜(く・う)(く・らう)(た・べる)(は・む)(ぐい)『うか『うけ『け『し
時	(ジ)〜(とき)(どき)(と)(とぎ)『さだ
寔	(ショク)〜(これ)(じき)(まことに)
塒	(シ)(ジ)〜(ねぐら)(とや)(とぐろ)『とぐら
蒔	(シ)(ジ)〜(う・える)(まく)(まい)(まか)(まき)
鉐	(セキ)(ジャク)
蝕	(ショク)〜(むしば・む)
實	{實}実。(ジツ)(シツ)〜(み)(みの・る)(まこと・に)(みの・り)(みち・る)(さな)(さね)(みつ)『ざね『じち『まこと『まめ『むざね
鮖	(かじか)
識	(シキ)〜(さと)(さとる)『シ『しる『しるす
史	(シ)〜(あきら)(あや)(お)(こ)(ちか)(とし)(なか)(のぶ)(ひさ)(ひと)(ふみ)『さかん『ふひと『ふみひと
矢	(シ)〜(や)『さ
豕	(シ)〜(いのこ)『ぶた『ゐ
使	(シ)〜(つか・う)(つか・い)(つか・い)(づか・い)『しむ『せしむ
始	(シ)〜(はじ・める)(はじ・める)(はじ・まる)(もと)
屎	(シ)(キ)〜(くそ)『ばば
笶	(シ)
榁	(むろ)
駛	(シ)〜(は・せる)(はや・い)
士	(シ)〜(お)(ま)(さむらい)『さむらひ『ジ
氏	(シ)〜(うじ)(うじ)『うぢ
示	(ジ)(シ)〜(しめ・す)
世	(セイ)(セ)(ソウ)〜(よ)(さんじゅう)(とし)(ゆ)(ゆき)
丗	(セイ)(セ)(ソウ)〜(よ)(さんじゅう)
仕	(シ)(ジ)〜(つか・える)『つかまつる
市	(シ)〜(いち)(い)(ち)
市座	いちくら
式	(シキ)〜(のり)『ショク
似	(ジ)〜(に・る)(ひ・る)(にた)『に
亊	(ジ)(シ)(ズ)〜(こと)(つか・う)(つか・える)
事	(ジ)(ズ)〜(こと)(つか・う)(つか・える)(ろ)『ごと
侍	(ジ)(シ)〜(さむらい)(はべ・る)(かみ)『さぶらい『さぶらう『さぶらひ『さむらひ
拭	(ショク)(シキ)〜(ぬぐ・う)(ふ・く)
柿	(シ)〜(かき)(こけら)『かき
是	(ゼ)(シ)〜(これ)『こ『ここ『この
恃	(ジ)(シ)〜(たの・む)
室	(シツ)〜(むろ)『しち
室鰺	あぢ『むろあじ
逝	(セイ)〜(ゆ・く)『いく
舐	(シ)〜(ねぶ・る)(な・める)
笹	(ささ)(さ)(さき)(しの)(じね)
釈	{釋}釈。(シャク)(セキ)〜(とく)(す・てる)(ゆる・す)(しゃ)『とける
視	〔視〕視。(シ)〜(み・る)(とも)(み)
貰	(セイ)(シャ)〜(もら・う)
弑	{弒}弑。(シ)(シイ)〜(しい・する)
勢	(セイ)(ゼイ)〜(いきお・い)(はずみ)(せ)
軾	(ショク)(シキ)〜(しきみ)
嗜	(シ)〜(たしな・む)(たしな・み)(この・む)(この・み)
筮	(ゼイ)(セイ)〜(うらな・う)(めどぎ)
弒	{弒}弑。シ『シイ
飾	(ショク)〜(かざ・る)(かざ・り)(しか)
試	(シ)〜(こころ・みる)(ため・す)
誓	(セイ)〜(ちか・う)
適	(テキ)〜(かな・う)『たま『たまたま
餝	(コウ)(シキ)(ショク)〜(かざり)(かざ・る)
噬	(ゼイ)〜(か・む)
諡	{謚}諡。(エキ)(シ)〜(おくりな)
螫	(セキ)(カク)〜(さ・す)
謚	{謚}諡。(エキ)(シ)〜(おくりな)
釋	{釋}釈。(シャク)(セキ)〜(とく)(す・てる)(ゆる・す)『とける
匙	(シ)〜(さじ)『かい『かひ『しゃじ
収	〔收〕収。(シュウ)〜(おさ・める)(おさ・まる)(のぶ)『シウ
收	〔收〕収。(シュウ)〜(おさ・める)(おさ・まる)『シウ
手	(シュ)(ズ)〜(て)(て)(て)(た)『ス
手の平	てのひら
手纏	たまき
手斧	ちょうな『てうな
手貫	たぬき
手繈	{手繈}手繦。たすき
手繦	{手繈}手繦。たすき
守	(シュ)(ス)〜(まも・る)(まも・り)(もり)(もり)(かみ)(う)(し)(も)(て)『かう『こう
首	(シュ)〜(くび)(おびと)(こべ)(す)『かうべ『かしら『こうべ『しるし『つかさ『はじめ
首級	しるし
寿	{壽}寿。(ジュ)(ス)(シュウ)〜(ことぶき)(ことぶ・く)(ことほ・ぐ)(かず)(じ)(じゅう)(すっ)(すみ)(とし)(としかつ)(なが)(のぶ)(のり)(ひさ)(ひさし)(やす)
受	(ジュ)〜(う・ける)(う・け)(う・かる)(じょ)
狩	(シュ)〜(か・る)(か・り)(が・り)(かり)
狩（り）	かり
授	(ジュ)〜(さず・ける)(さず・かる)
售	(シュウ)〜(う・る)
痩	{瘦}痩。(ソウ)(チュウ)(シュウ)(シュ)〜(や・せる)
壽	{壽}寿。(ジュ)(ス)(シュウ)〜(ことぶき)(ことぶ・く)(ことほ・ぐ)(かず)(じ)(とし)(ひさ)(ひさし)
瘦	{瘦}痩。ソウ『やせる
綬	(ジュ)〜(ひも)
獣	{獸}獣。(ジュウ)〜(けもの)(けだもの)『ジウ『しし
獸	{獸}獣。(ジュウ)〜(けもの)(けだもの)『ジウ『しし
殳	(シュ)〜(また)(ほこ)(ほこつくり)(るまた)
疋	(ヒキ)(ショ)(ソ)(ヒツ)〜(あし)『き『びき『ぴき『むら
抒	(ジョ)(ショ)〜(く・む)(の・べる)
枢	{樞}枢。(スウ)(シュ)〜(とぼそ)(からくり)『くる『くるる『くろろ『とまら
叔	(シュク)〜(よし)
殊	(シュ)〜(こと)『ジュ
倏	(シュク)〜(たちまち)
書	(ショ)〜(か・く)(が・き)(がき)(かき)『ふみ
菽	(シュク)〜(まめ)
梳	(ソ)〜(と・く)(と・かす)(す・く)(けず・る)(くしけず・る)『くし
淑	(シュク)〜(しと・やか)(すく)(とし)(よし)
舒	(ジョ)(ショ)〜(の・べる)
疎	(ソ)(ショ)〜(うと・い)(うと・む)(まば・ら)『おろ『おろそか
疏	(ソ)(ショ)〜(あら・い)(うと・い)(うと・む)(とお・る)(とお・す)(まばら)『さかん
踈	(ソ)(ショ)〜(うと・い)(うと・む)(まば・ら)
蔬	(ソ)(ショ)〜(あおもの)『くさびら
樞	{樞}枢。(スウ)(シュ)〜(とぼそ)(からくり)『くる『くるる『くろろ『とまら
輸	(ユ)(シュ)
孰	(ジュク)〜(いずれ)(たれ)
塾	(ジュク)
熟	(ジュク)〜(う・れる)『こなれる『つくづく『つらつら『なれる『にえる『にき『にる
熟々	つらつら
贖	(ショク)〜(あがな・う)
鼡	(ソ)(ショ)〜(ねずみ)(ねず)
暑	〔暑〕暑。(ショ)〜(あつ・い)
黍	(ショ)〜(きび)『きみ
属	{屬}属。(ゾク)(ショク)〜(さかん)(つく)(やから)(さっか)(つき)
署	〔署〕署。(ショ)
蜀	(ショク)(ゾク)〜(いもむし)
鼠	(ソ)(ショ)〜(ねずみ)(ねず)
薯	(ショ)〜(いも)『ジョ
曙	(ショ)〜(あけぼの)
籔	(ソウ)〜(やぶ)
屬	{屬}属。(ゾク)(ショク)〜(さかん)(つく)(やから)
鱪	しいら
鱰	しいら
朮	(ジュツ)(シュツ)(チュツ)〜(もちあわ)(おけら)『うけら『をけら
戍	(ジュ)(シュ)〜(まもり)(まも・る)
束	(ソク)〜(たば)(たば・ねる)(つか)(つか・ねる)
述	(ジュツ)〜(の・べる)
恕	(ジョ)(ショ)〜(ゆる・す)
術	(ジュツ)〜(すべ)『ばけ『わざ
庶	(ショ)『こいねがう
竪	{豎}竪。(ジュ)〜(たて)(た・てる)(こども)
数	{數}数。(スウ)(ス)(サク)(ソク)(シュ)〜(かず)(かぞ・える)(しばしば)(せ・める)(わずらわ・しい)(じゅ)
墅	(ショ)(ヤ)〜(しもやしき)
漱	(ソウ)(シュウ)(ス)〜(くちすす・ぐ)(くちそそ・ぐ)(うがい)(すす・ぐ)
豎	{豎}竪。(ジュ)〜(たて)(た・てる)(こども)『たつ
數	{數}数。(スウ)(ス)(サク)(ソク)(シュ)〜(かず)(かぞ・える)(しばしば)(せ・める)(わずらわ・しい)
樹	(ジュ)〜(き)(いつき)(うえ)(こ)(しげ)(じ)(たちき)(たつ)(たつる)(な)『たてる
刷	(サツ)〜(す・る)(ず・り)(ずり)(は・く)
衰	(スイ)〜(おとろ・える)
帥	(スイ)『かみ『ソチ『ソツ
蟀	(シュツ)
閂	(サン)(セン)〜(かんぬき)『クワン
栓	(セン)
双	{雙}双。(ソウ)〜(ふた)(たぐい)(ならぶ)(ふたつ)(ふ)『サウ
滝	{瀧}滝。(ロウ)(ソウ)〜(たき)(らき)『たき
霜	(ソウ)〜(しも)『サウ
雙	{雙}双。(ソウ)〜(たぐい)(ならぶ)(ふたつ)(ふた)『サウ
孀	(ソウ)〜(やもめ)
爽	(ソウ)〜(あき・らか)(さわ・やか)(たがう)『サウ
誰	(スイ)〜(だれ)(たれ)(た)『だれ
水	(スイ)〜(みず)(みず)(うず)(ずみ)(つ)(ど)(み)(みさ)(みつ)(みな)(みん)『みづ『もい『もひ
水蕗	みずぶき『みずふぶき『みづ
水掻き	みずかき『みづ
水搔き	みずかき『みづ
水押し	みよし
閖	(ヘイ)〜(ゆ・る)
稅	{稅}税。ゼイ『ちから
税	{稅}税。(ゼイ)〜(さい)『ちから
睡	(スイ)『ねむり『ねむる
吮	(セン)(シュン)〜(す・う)
順	(ジュン)〜(あや)(あり)(おき)(おさむ)(しげ)(したがう)(とし)(なお)(のぶ)(のり)(まさ)(むね)(もと)(ゆき)(よし)(より)『ずん
舜	(シュン)〜(みつ)
蕣	(シュン)〜(むくげ)(あさがお)
瞬	(シュン)〜(またた・く)『めまじろぎ
說	{說}説。ゼイ『セツ『とく
説	{說}説。(セツ)(ゼイ)〜(と・く)(さとし)(とき)
妁	(シャク)〜(なこうど)
朔	(サク)〜(ついたち)(たち)
朔日	ついたち
蒴	さく
碩	(セキ)〜(おお・きい)
槊	(サク)〜(ほこ)
爍	(シャク)〜(とか・す)(ひか・る)
鑠	(シャク)〜(とろ・かす)(と・かす)
厶	(シ)(ボウ)(ム)〜(わたくし)(ござ・る)(む)
司	(シ)〜(つかさど・る)(つ)(つか)(つかさ)『スṬ『みこともち
私	(シ)〜(わたくし)(わたし)『あたい『あたくし『あたし『あっし『あて『ひそかに『わい『わし『わたい『わちき『わっし『わっち『わて『わらは『わらわ
思	(シ)〜(おも・う)(おもえら・く)(おぼ・す)
斯	(シ)〜(か)(こう)(か・く)(この)(これ)(ここに)
絲	〔絲〕糸。(シ)〜(いと)
厮	(シ)〜(こもの)
撕	(セイ)(シ)
嘶	(セイ)〜(いなな・く)
廝	(シ)〜(こもの)
死	(シ)〜(し・ぬ)(し・に)
偲	(サイ)(シ)〜(しの・ぶ)
巳	(シ)〜(み)
四	(シ)〜(よ)(よ・つ)(よっ・つ)(よん)(あ)(つ)(よつ)『スー
寺	(ジ)〜(てら)
伺	(シ)〜(うかが・う)
祀	(シ)〜(まつ・る)(まつり)
価	{價}価。(カ)(ケ)〜(あたい)『あたひ
泗	(シ)〜(なみだ)
俟	(シ)〜(ま・つ)
耜	(シ)〜(すき)
笥	(ス)(シ)〜(け)(はこ)
竢	(シ)〜(まつ)
覗	(シ)〜(のぞ・く)(うかが・う)
肆	(シ)〜(つら・ねる)(ほしいまま)(みせ)『いちくら
嗣	(シ)〜(あき)(つかさ)(つぎ)(つぐ)(ひで)
飼	(シ)〜(か・う)(かい)
駟	(シ)
松	(ショウ)〜(まつ)(おお)(しょ)(ま)(まっ)
松明	たいまつ
松魚	かつお『かつを
枩	(ショウ)〜(まつ)
菘	(スウ)(シュウ)
淞	(ショウ)
愡	(ソウ)
嵩	(スウ)(シュウ)〜(かさ)(かさ・む)(たか・い)(たかし)(たか)(たけ)
鬆	(ショウ)(ソウ)(シュ)『す
悚	(ショウ)〜(おそ・れる)
竦	(ショウ)〜(すく・む)(おそ・れる)(つつし・む)
慫	(ショウ)〜(すす・める)
聳	(ショウ)〜(そび・える)『そばだつ『そびやかす
宋	(ソウ)
送	(ソウ)〜(おく・る)
訟	(ショウ)『うったえる
頌	(ショウ)(ジュ)(ヨウ)〜(かたち)(たた・える)(ほめ・る)(つぐ)(のぶ)『いはひ『いわいうた
誦	(ショウ)(ジュ)(ズ)〜(とな・える)(よ・む)『そらんじる
鎹	(かすがい)『かすがひ
捜	〔搜〕捜。(ソウ)(シュ)(シュウ)〜(さが・す)『サウ
搜	{搜}蒐。(ソウ)(シュ)(シュウ)〜(さが・す)『あつめる『サウ『シウ
蒐	{搜}蒐。(シュウ)〜(あかね)(あつ・まる)(あつ・める)『シウ
溲	(シュ)(シュウ)(ソウ)〜(いばり)(ひた・す)
艘	(ショウ)(シュウ)(ソウ)〜(ふね)『サウ
叟	(ソウ)(シュウ)〜(おきな)
嗾	(ゾク)(ソク)(ソウ)〜(けしか・ける)(そそのか・す)
薮	(ソウ)〜(やぶ)
藪	(ソウ)〜(やぶ)
嗽	(ソウ)(シュウ)(ソク)〜(すす・ぐ)(ゆす・ぐ)(くちすす・ぐ)『うがい『うがひ
甦	{蘇}甦。(ソ)(コウ)〜(よみがえ・る)
酥	(ソ)
蘓	(ソ)(ス)〜(よみがえ・る)
蘇	{蘇}甦。(ソ)(ス)〜(よみがえ・る)
俗	(ゾク)『しょく
夙	(シュク)〜(つとに)(はやい)
泝	(ソ)〜(さかのぼる)
素	(ソ)(ス)〜(もと)『もとより
速	(ソク)〜(はや・い)(はや)(はや・める)(すみ・やか)(わ)『はやまる
粛	{肅}粛。(シュク)(スク)〜(つつし・む)
粟	(ゾク)(ショク)(ソク)〜(あわ)(もみ)(あ)(さっ)(そう)『あは
訴	(ソ)〜(うった・える)
塑	(ソ)〜(でく)
遡	{溯}遡。(ソ)(サク)〜(さかのぼ・る)
溯	{溯}遡。(ソ)(サク)〜(さかのぼ・る)
肅	{肅}粛。(シュク)(スク)〜(つつし・む)
愬	(ソ)(サク)〜(うった・える)
餗	こなかき
謖	(ショク)(シュク)〜(た・つ)
酸	(サン)〜(す・い)『す
蒜	(サン)〜(にんにく)(ひる)(のびる)
算	(サン)〜(そろ)『かぞえる
夊	(スイ)〜(ゆき)(すいにょう)
雖	(スイ)〜(いえど・も)(これ)
隋	(ズイ)(スイ)(タ)
随	{隨}随。(ズイ)〜(まにまに)(したが・う)『まにま『まま
随意	{隨意}随意。まにま
綏	(スイ)(タ)〜(やす・い)
隨	{隨}随。(ズイ)〜(まにまに)(したが・う)『まにま『まま
隨意	{隨意}随意。まにま
膸	(ズイ)
髄	{髓}髄。(ズイ)『ずん『なずき『なづき
髓	{髓}髄。(ズイ)『ずん『なずき『なづき
砕	〔碎〕砕。(サイ)〜(くだ・く)(くだ・ける)
粋	{粹}粋。(スイ)〜(いき)
祟	(スイ)〜(たた・る)(たた・り)
埣	(ソツ)
遂	(スイ)〜(と・げる)(つい・に)『つい『つひ
碎	〔碎〕砕。(サイ)〜(くだ・く)(くだ・ける)
歲	{歲}歳。サイ『セイ『とし『とせ
歳	{歲}歳。(サイ)(セイ)〜(とし)(とせ)(よわい)
隧	(スイ)(ツイ)〜(みち)『ズイ
穂	{穗}穂。(スイ)〜(ほ)(お)(こう)(のり)(ほい)
燧	(スイ)〜(ひうち)(ひきり)(のろし)『とぶひ
穗	{穗}穂。(スイ)〜(ほ)(お)
邃	(スイ)〜(おくぶか・い)『ふかい
孫	(ソン)〜(まご)(ひ)『うまご『ひこ『むまご
笋	{筍}笋。(ジュン)(シュン)(イン)〜(たけのこ)(たかんな)『たかむな
隼	(シュン)(ジュン)〜(はやぶさ)(はや)
筍	{筍}笋。(ジュン)(シュン)(イン)〜(たけのこ)(たかんな)『たかうな『たかむな『たこうな
損	(ソン)〜(そこ・なう)(そこな・う)(そこ・なう)(そこ・ねる)(そこ・ねる)
唆	(サ)〜(そそのか・す)
娑	(シャ)(サ)
梭	(サ)〜(ひ)
梭魚	かます
梭子魚	かます
蓑	{蓑}簑。(サ)(サイ)〜(みの)
簑	{蓑}簑。(サ)(サイ)〜(みの)
簔	(サ)(サイ)〜(みの)
縮	(シュク)〜(ちぢ・む)(ちぢ・まる)(ちぢ・める)(ちぢ・れる)(ちぢ・らす)
所	(ショ)〜(ところ)(ところ)(どころ)(とこ)(せ)『く『と
所縁	{所緣}所縁。ゆかり
所緣	{所緣}所縁。ゆかり
索	(サク)『もとめる
瑣	(サ)〜(ちいさ・い)(くさり)
鎖	{鎖}鏁。(サ)〜(くさり)(とざ・す)『じょう『ヂヤウ｜ジヤウ
鏁	{鎖}鏁。くさり『じょう『ヂヤウ｜ジヤウ
他	(タ)〜(ほか)『あだし
他所	よそ
它	(タ)〜(へび)
塔	(トウ)『あららぎ『タフ
獺	(ダツ)(タツ)〜(うそ)(かわ)(かわうそ)『おそ『かは『をそ
沓	(トウ)〜(くつ)『タフ
荅	(トウ)〜(あずき)(こた・える)
搨	(トウ)〜(う・つ)(す・る)
榻	(トウ)〜(こしかけ)(しじ)『しぢ『タフ『とん
撻	(タツ)〜(むちうつ)
踏	(トウ)〜(ふ・む)(ふ・まえる)『タフ
鞜	(トウ)〜(くつ)
鞳	(トウ)
闥	(タツ)(タチ)
胎	(タイ)
台	〔臺〕台。(ダイ)(タイ)〜(うてな)(われ)(つかさ)
抬	(タイ)〜(もた・げる)
苔	(タイ)〜(こけ)(こけら)
臺	〔臺〕台。(ダイ)(タイ)〜(うてな)(われ)(つかさ)
颱	(タイ)
駘	(タイ)
擡	(タイ)〜(もた・げる)
薹	(タイ)〜(とう)(あぶらな)『タウ
太	(タイ)(タ)〜(ふと・い)(ふと・る)(おお)(たか)(ひろ)『ふと
太藺	ふとい『ゐ
汰	(タ)(タイ)〜(おご・る)(にご・る)(よな・げる)
泰	(タイ)〜(た)(はす)(ひろ)(や)(やす)(やすし)(ゆたか)(よし)
態	(タイ)〜(わざ・と)『ざま『てい『なり『わざ
貪	(タン)(トン)〜(むさぼ・る)『ドン
攤	(タン)〜(ひら・く)『だ
灘	(タン)(ダン)〜(なだ)(せ)(だな)(なん)
覃	(タン)(エン)
弾	〔彈〕弾。(ダン)(タン)〜(ひ・く)(ひ・き)(はず・む)(たま)(はじ・く)(はじ・ける)(ただ・す)(はじ・きゆみ)
痰	(タン)
談	(ダン)
潭	(タン)(ジン)〜(ふち)(ふか・い)
壇	(ダン)(タン)
曇	(ドン)〜(くも・る)(ど)(ずみ)『タン
檀	(ダン)(タン)〜(まゆみ)
壜	(ドン)(タン)〜(びん)
譚	(タン)〜(はなし)
罎	(ドン)(タン)〜(びん)
坦	(タン)〜(たいら)(やす)
袒	(タン)〜(かたぬ・ぐ)
毯	(タン)
炭	(タン)〜(すみ)
探	(タン)〜(さぐ・る)(さが・す)
嘆	{嘆}歎。(タン)〜(なげ・く)(なげ・かわしい)
歎	{嘆}歎。(タン)〜(なげ・く)(なげ・き)
湯	(トウ)〜(ゆ)『タウ『タンṬ
蝪	(エキ)
唐	(トウ)〜(から)(かろ)(たん)『タウ『もろこし
唐鋤	からすき
唐土	もろこし
堂	(ドウ)『ダウ
棠	(トウ)〜(やまなし)
棠梨	ずみ
塘	(トウ)〜(つつみ)(とも)
溏	(トウ)
糖	(トウ)『あめ『タウ
螳	(トウ)
帑	(トウ)(ド)〜(かねぐら)
淌	(トウ)
儻	(トウ)〜(あるいは)(すぐ・れる)(もし)
涛	(トウ)〜(なみ)(と)
掏	(トウ)〜(す・る)(えら・ぶ)
絛	(ジュウ)(ジョウ)(トウ)〜(さなだ)
滔	(トウ)〜(はびこ・る)『タウ
濤	(トウ)〜(なみ)『タウ
韜	(トウ)〜(ゆぶくろ)(ゆみぶくろ)(つつ・む)
饕	(トウ)〜(むさぼ・る)
迯	(トウ)〜(に・げる)(に・がす)(のが・す)(のが・れる)
逃	(トウ)〜(に・げる)(に・がす)(のが・す)(のが・れる)『タウ『チョウ『テウ
桃	(トウ)〜(もも)(み)(もの)『タウ
桃花鳥	とき
陶	(トウ)〜(す)(すえ)『すゑ『タウ
萄	(ドウ)(トウ)
梼	(トウ)〜(ゆす)
淘	(トウ)〜(よな・げる)『タウ
綯	(トウ)〜(な・う)(なわ)(よ・る)
檮	(トウ)〜(し)
討	(トウ)〜(う・つ)『タウ『たずねる
套	(トウ)〜(かさ・ねる)『タウ
特	(トク)
慝	(トク)〜(わる・い)
疼	(トウ)〜(うず・く)(いた・む)
滕	(トウ)〜(わ・く)
縢	(トウ)〜(かが・る)(かな)(から・げる)(むかばき)
謄	(トウ)『うつす
藤	{藤}籐。(トウ)(ドウ)〜(ふじ)(ぞう)(と)(ふじゅ)『おこぜ『ふぢ『をこぜ
騰	(トウ)『あがる『のぼる
籐	{藤}籐。(トウ)
鰧	{藤}鰧。おこぜ『をこぜ
籘	(トウ)
剔	(テキ)(テイ)〜(えぐ・る)(そ・る)
梯	(テイ)(タイ)〜(はしご)(だい)『かけはし『はし
提	(テイ)(チョウ)(ダイ)〜(さ・げる)『ひさげ
提子	ひさげ
啼	(テイ)〜(な・く)
醍	(ダイ)(タイ)(テイ)
蹄	(テイ)〜(ひづめ)
題	(ダイ)
鵜	(テイ)(ダイ)〜(う)
鯷	しこ『ひしこ
体	{體}体。(タイ)(テイ)〜(からだ)(かたち)(なり)
躰	{體}躰。(タイ)(テイ)〜(からだ)(かたち)
軆	(タイ)(テイ)〜(からだ)(かたち)
體	{體}体。(タイ)(テイ)〜(からだ)(かたち)
戻	〔戾〕戻。(レイ)〜(もど・す)(もど・る)『もとる
剃	{剃}薙。(テイ)〜(まい)(そ・る)(す・る)『か『ぐ『そ『チ『な『なぎ『み『る
洟	(イ)(テイ)〜(はな・しる)(はな・じる)『すすばな『つきはな『はな
逖	(テキ)〜(とお・い)
涕	(テイ)〜(なみだ)(な・く)
悌	(テイ)(ダイ)〜(とも)(やす)(やすし)(よし)(ちか)
替	(タイ)〜(か・える)(か・え)(か・わる)(かえ)
裼	(セキ)(テイ)〜(はだぬ・ぐ)
嚏	{嚏}嚔。(テイ)〜(くしゃみ)(くさめ)(くさみ)『くっさめ
嚔	{嚏}嚔。(テイ)〜(くしゃみ)(くさめ)(くさみ)『くっさめ
天	(テン)〜(あまつ)(あめ)(あま)(あき)(あも)(た)(たかし)(て)(なま)
添	(テン)〜(そ・える)(そ・う)(も・える)(も・う)(そえ)(ぞい)
添ひ	そい『そひ
田	(デン)〜(た)(いなか)(おか)(たん)(で)(とう)(や)
田鶴	たず『たづ
沺	(デン)
畋	(デン)(テン)〜(かり)
畑	(はた)(はたけ)(ばたけ)(かま)(まま)『はた
恬	(テン)〜(やすら・く)(やす・い)
畠	(はたけ)(はた)(はな)
甜	(テン)〜(うま・い)(あま・い)
填	{填}塡。(テン)(チン)〜(は・まる)(は・める)(うず・める)(しず・める)(ふさ・ぐ)(まき)
塡	{填}塡。テン
碵	(せき)(ひろ)
鴫	(しぎ)
鷏	(テン)(シン)〜(かすい)
鷆	(テン)(シン)〜(かすい)
忝	(テン)〜(かたじけな・い)
殄	(テン)〜(た・つ)(つき・る)(つく・す)
腆	(テン)〜(あつ・い)
靦	(テン)
佻	(チョウ)(ジョウ)(ヨウ)〜(かる・い)
挑	(チョウ)〜(いど・む)『テウ
条	{條}条。(ジョウ)(チョウ)(デキ)〜(えだ)(すじ)『くだり『すぢ『デウ
迢	(チョ)(チョウ)〜(はる)
條	{條}条。(ジョウ)(チョウ)(デキ)〜(えだ)(すじ)『くだり『すぢ『デウ
蓚	(シュウ)
蜩	(チョウ)〜(ひぐらし)(せみ)
髫	(チョウ)〜(うな・る)(うな・い)『ゐ
髫髪	うない『ゐ
齠	(チョウ)
窕	(チョウ)(ヨウ)〜(うつく・しい)
誂	(チョウ)〜(あつら・える)(いど・む)
眺	(チョウ)〜(なが・める)『テウ
跳	(チョウ)〜(は・ねる)(と・ぶ)(と・び)『テウ
糶	(チョウ)〜(せり)(うりよね)
帖	(チョウ)(ジョウ)〜(かきもの)『テフ『デフ
貼	(テン)(チョウ)〜(は・る)(つ・く)『テフ
鉄	{鐵}鉄。(テツ)〜(くろがね)(けん)(てっ)
鉄掻き	かながき
僣	(シン)(セン)〜(せん・する)(おご・る)
鐡	(テツ)〜(くろがね)
鐵	{鐵}鉄。(テツ)〜(くろがね)
餮	(テツ)〜(むさぼ・る)
庁	〔廳〕庁。(チョウ)(テイ)〜(やくしょ)『チャウ『チヤウ
汀	(テイ)〜(みぎわ)(なぎさ)(て)
听	{聽}听。(キン)〜(ぽんど)(わら・う)
渟	(テイ)〜(とど・まる)(ぬ)
聴	〔聽〕聴。(チョウ)(テイ)〜(き・く)(ゆる・す)(きく)『チャウ
廰	(チョウ)(テイ)〜(やくしょ)
聽	{聽}听。(チョウ)〜(き・く)(ゆる・す)『きん『チャウ
廳	〔廳〕庁。(チョウ)(テイ)〜(やくしょ)『チャウ
廷	(テイ)〜(たか)
亭	(テイ)(チン)Ṭ
庭	(テイ)〜(にわ)(ば)『には
停	(テイ)〜(と・める)(と・まる)『チャウ『チョウ『とどまる『とどめる
霆	(テイ)〜(いかづち)
挺	(チョウ)(テイ)〜(ぬ・く)『チャウ『チヤウ
梃	(チョウ)(テイ)〜(てこ)(つえ)『チヤウ
艇	(テイ)
囲	〔圍〕囲。(イ)〜(かこ・む)(かこ・う)(かこ・い)『ヰ
通	(ツウ)(ツ)〜(とお・る)(とお・り)(とお・り)(どお・り)(とお・す)(とお・し)(どお・し)(かよ・う)(とん)(どうし)(どおり)(みち)
樋	(トウ)〜(ひ)(とい)(て)(と)(とよ)(とわ)『とひ
冂	(キョウ)(ケイ)〜(まきがまえ)(えながまえ)(どうがまえ)(けいがまえ)
仝	(どうじょう)
同	(ドウ)〜(おな・じ)
桐	(トウ)(ドウ)〜(きり)(ひさ)(き)
童	(ドウ)〜(わらべ)(ぱ)『わっぱ『わらし『わらは『わらわ『わらんべ
童部	わらんべ
粡	(トウ)
僮	(トウ)(ドウ)〜(しもべ)(わらべ)
銅	(ドウ)〜(あかがね)
潼	(ドウ)(トウ)
橦	(シュ)(ショウ)(トウ)
瞳	(ドウ)(トウ)〜(ひとみ)(あきら)
桶	(ヨウ)(トウ)〜(おけ)『を
筒	(トウ)〜(つつ)『どう
統	(トウ)〜(す・べる)(ほび・る)(のり)(むね)
痛	(ツウ)〜(いた・い)(いた・む)(いた・ましい)(いた・める)『いたく
慟	(ドウ)(トウ)〜(なげ・く)
偷	{偷}偸。チュウ『トウ『ぬすむ
偸	{偷}偸。(ツ)(トウ)(チュウ)〜(ぬす・む)
鍮	(チュウ)(トウ)
投	(トウ)〜(な・げる)(な・げ)
骰	(トウ)〜(さい)
頭	(トウ)(ズ)(ト)〜(あたま)(かしら)(がしら)(かぶり)(かみ)(がみ)(ちゃん)(つむり)(づ)『かうべ『かぶ『こうべ『ジュウ（ヂュウ）Ṭ『つぶり『つむ
殕	(フ)〜(ね・る)
透	(トウ)〜(す・く)(す・かす)(す・ける)(とう・る)(とう・す)(とおる)
透き	すき
凸	(トツ)〜(でこ)
禿	(トク)〜(ちび・る)(かむろ)(は・げる)(はげ)『かぶろ
突	〔突〕突。(トツ)(カ)〜(つ・く)
図	〔圖〕図。(ズ)(ト)〜(え)(はか・る)(づ)
荼	(タ)(ズ)(ト)(ダ)〜(にがな)
徒	(ト)〜(いたずら)(あだ)(かち)『いたづら『ズ『ただ『ヅ『むだ
徒步	{徒步}徒歩。かち
徒歩	{徒步}徒歩。かち
途	(ト)〜(みち)『ズ『ヅ
屠	(ト)(チョ)〜(ほふ・る)
塗	(ト)〜(ぬ・る)(ぬ・り)(まみ・れる)
跿	(ト)
圖	〔圖〕図。(ズ)(ト)〜(え)(はか・る)『ヅ
土	(ド)(ト)〜(つち)(つ)(つく)(は)(ひじ)『に
土鳩	どばと
土塊	つちくれ
吐	(ト)〜(は・く)(つ・く)
汢	(ヌタ)
兎	{兔}兎。(ト)(ツ)〜(うさぎ)『う『おさぎ『をさぎ
兔	{兔}兎。(ト)(ツ)〜(うさぎ)『う『おさぎ『をさぎ
莵	(ト)(ツ)〜(うさぎ)
菟	(ト)(ツ)〜(うさぎ)(う)
猯	(タン)〜(いのしし)(まみ)
湍	(タン)〜(はや・い)(はやせ)
貒	まみ
団	〔團〕団。(ダン)(トン)〜(かたまり)(まる・い)
団栗	{團栗}団栗。どんぐり
摶	(タン)(セン)〜(まる・い)
蓴	(シュン)〜(ぬなわ)
團	〔團〕団。(ダン)(トン)〜(かたまり)(まる・い)
團栗	{團栗}団栗。どんぐり
慱	(タン)
槫	(タン)(セン)
彖	(タン)
推	(スイ)〜(お・す)
頹	{頹}頽。くずれる『タイ
頽	{頹}頽。(タイ)〜(くず・れる)
腿	(タイ)〜(もも)
退	(タイ)〜(しりぞ・く)(しりぞ・ける)(ひ・く)(の・く)(の・ける)(ど・く)『しさる『すさる
蛻	(ゼイ)(セイ)(タイ)〜(もぬ・ける)(ぬけがら)
褪	(タイ)(トン)〜(あ・せる)(ぬ・ぐ)
呑	(トン)(ドン)〜(の・む)
暾	(トン)〜(あさひ)
屯	(トン)『たむら『たむろ
豚	(トン)〜(ぶた)
飩	(ドン)(トン)
臀	(デン)(トン)〜(しり)
托	(タク)〜(たく・する)(たの・む)
託	(タク)〜(かこつ・ける)(かこ・つ)(かこ・つける)『ことづける
脫	{脫}脱。ダツ『ぬく『ぬぐ『ぬける『ぬげる
脱	{脫}脱。(ダツ)〜(ぬ・ぐ)(ぬ・げる)『ぬく『ぬける
佗	(タ)(イ)〜(わび・しい)(わび)(ほか)(わ・びる)
陀	(タ)(ダ)(イ)(チ)(ジ)〜(けわ・しい)(ななめ)
沱	(タ)(ダ)
柁	(ダ)(タ)〜(かじ)
詑	(イ)(タ)(ダ)〜(わ・びる)(わ・び)(あざむ・く)
馱	{馱}駄。タ『ダ『においうま
鉈	(シャ)〜(なた)(ほこ)
駄	{馱}駄。(ダ)(タ)『においうま
駝	(ダ)(タ)〜(せむし)
橐	つは『つわぶき
橐吾	つは『つわぶき
鴕	(ダ)(タ)
騨	(タン)(ダン)(タ)(ダ)(テン)
妥	(ダ)〜(やす)
楕	{橢}楕。(ダ)(タ)
橢	{橢}楕。(ダ)
拓	(タク)〜(ひら・く)(つ)(ひろ)
柝	(タク)〜(ひょうしぎ)
唾	(ダ)(タ)〜(つば)(つばき)『つ『つは『つわ『つわき『はき
哇	(ア)(アイ)(エ)(ワ)〜(かい)(けい)
蛙	(ア)(ワ)〜(かえる)(かわず)『かいる『かはづ『かへる
窪	(ワ)(ア)〜(くぼ・む)(くぼ・み)(くぼ・まる)(くぼ)『いしま
娃	(ア)(アイ)(ワ)〜(うつく・しい)(い)
譁	{嘩}譁。(カ)(ケ)〜(かまびす・しい)『クヮ
瓦	(ガ)〜(かわら)(ぐらむ)『かはら『グヮ
瓲	(とん)
膃	(オツ)
襪	(ベツ)(バツ)『うづ『したうず『したうづ『しとうず
韈	(ベツ)(モチ)(バツ)(マチ)〜(くつした)(たび)
咼	(カイ)(ケ)(クウ)(カ)〜(よこしま)(くちがゆがむ)(ゆが・む)
歪	(ワイ)(エ)〜(いが・む)(いびつ)(ひず・む)(ゆが・む)
外	(ガイ)(ゲ)〜(そと)(ほか)(はず・す)(はず・れる)(と)(け)(ふか)『ウイṬ『グヮイ『よそ
弯	(ワン)〜(ひ・く)
湾	〔灣〕湾。(ワン)〜(いりえ)
蜿	(エン)(ワン)
豌	(エン)(ワン)
彎	(ワン)〜(ひ・く)
灣	〔灣〕湾。(ワン)〜(いりえ)
丸	(ガン)〜(まる)(まる・める)(まる・い)(ま)(わ)(わに)『グヮン『まろ
丸かし	まるかし『まろかし
丸かせ	まるかせ『まろかせ
完	(カン)『クヮン
玩	(ガン)〜(もちあそ・ぶ)(もてあそ・ぶ)『グヮン
笂	(うつぼ)
頑	(ガン)〜(かたく)『かたくな『グヮン『グワン
宛	(エン)〜(あ・てる)(あて)(づつ)(あたか・も)『あてる『ずつ『ヱン
挽	(バン)〜(ひ・く)(ひき)
盌	{碗}盌。もい『もひ『わん
埦	{碗}埦。わん
晚	{晚}晩。バン
婉	(エン)〜(うつく・しい)(したが・う)『ヱン
椀	{碗}椀。(ワン)〜(はち)『まり『もい『もひ
晩	{晚}晩。(バン)
皖	(カン)
碗	{碗}盌。(ワン)〜(こばち)『まり『もい『もひ
輓	(バン)〜(おそ・い)(ひ・く)
綰	(ワン)〜(わが・ねる)
万	{萬}万。(マン)(バン)〜(よろず)(かず)(ま)(ゆる)『よろづ
卍	(バン)(マン)〜(まんじ)
杤	(とち)
萬	{萬}万。(マン)(バン)〜(よろず)(かず)(ま)(ゆる)(よし)『よろづ
腕	(ワン)〜(うで)『かいな『かひな『ただむき
翫	(ガン)〜(もてあそ・ぶ)
汪	(オオ)(オウ)〜(ひろ)
亡	(ボウ)(モウ)〜(な・い)(な・き)(ほろ・びる)(ほろ・ぶ)(ほろ・ぼす)『バウ『マウ
王	(オウ)(ノウ)〜(おお)(おおきみ)(わ)『きみ『コキシ『コニキシ『ワウ
网	(モウ)(ボウ)〜(あみ)(あみがしら)(よんかしら)(よこめ)
枉	(オオ)(オウ)〜(ま・げる)(ま・がる)(ま・げて)『ワウ
罔	(モウ)(ボウ)〜(あみ)(しい・る)(ない)『バウ『マウ
徃	(オウ)〜(い・く)(いにしえ)(さき・に)(ゆ・く)(みち)
往	(オウ)〜(い・く)(いにしえ)(さき・に)(ゆ・く)(みち)『いぬ『ワウ
惘	(ボウ)(モウ)〜(あき・れる)
網	(モウ)〜(あみ)(あ)(ずな)『マウ
魍	(モウ)(ボウ)
妄	(モウ)(ボウ)〜(みだ・りに)『バウ『マウ『みだり
忘	(ボウ)〜(わす・れる)『バウ
旺	(オウ)(キョウ)(ゴウ)〜(かがや・き)(うつくし・い)(さかん)『ワウ
望	(ボウ)(モウ)〜(のぞ・む)(もち)(み)(も)『バウ『マウ
危	(キ)〜(あぶ・ない)(あや・うい)(あや・ぶむ)
威	(イ)〜(おど・す)(おど・し)(おど・かす)(いさ)(たけ)(たけし)『ヰ『をどし
逶	(イ)
隈	(ワイ)(エ)〜(くま)(すみ)
楲	いい『いひ
微	(ビ)〜(かす・か)(み)
縅	(おど・す)『おどし『をどし
薇	(ラ)(ビ)〜(ぜんまい)
巍	(ギ)〜(たか・い)(たかし)
鰄	(イ)『かいらぎ
囗	(イ)(コク)〜(くにがまえ)
為	〔爲〕為。(イ)〜(ため)(な・る)(な・す)(す・る)(たり)(つく・る)(なり)(びい)『す『た『ヰ
韋	(イ)〜(そむ・く)(なめしがわ)『ヰ
唯	(ユイ)(イ)〜(ただ)(ゆ)『たんだ『ヰ
帷	(イ)〜(とばり)『ヰ
惟	(イ)(ユイ)〜(おも・んみる)(これ)(おも・うに)(ただ)(よし)(のぶ)『ヰ
嵬	(カイ)(ギ)
幃	(イ)(キ)〜(とばり)
圍	〔圍〕囲。(イ)〜(かこ・む)(かこ・う)(かこ・い)『ヰ
爲	〔爲〕為。(イ)〜(ため)(な・る)(な・す)(す・る)(たり)(つく・る)(なり)『ヰ
違	(イ)〜(ちが・う)(ちが・い)(ちが・える)(ちが・える)(たが・う)(たが・える)『ヰ
維	(イ)〜(これ)(たもつ)(つぐ)(ゆい)(ゆき)『つなぐ『ヰ
鮠	(カイ)(ゲ)(ガイ)〜(はえ)(はや)
尾	(ビ)〜(お)『を
尾籠	おこ『をこ
委	(イ)〜(ゆだ・ねる)(まかせ)『くわしい『まかせる『ヰ
萎	(イ)〜(な)(しお・れる)(しな・びる)(しぼ・む)(な・える)『しおり『しをり『ヰ
梶	(ビ)〜(かじ)(こずえ)『かぢ
偽	〔僞〕偽。(ギ)(カ)〜(いつわ・る)(にせ)(いつわ・り)
偉	(イ)〜(えら・い)(ひで)『ヰ
隗	(カイ)〜(けわ・しい)『クワイ
葦	(イ)〜(しお・れる)(しな・びる)(しぼ・む)(な・える)(あし)『よし
猥	(ワイ)〜(みだ・ら)(みだり・に)『みだり
痿	(イ)〜(な・える)
僞	〔僞〕偽。(ギ)(カ)〜(いつわ・る)(いつわ・り)(にせ)
緯	(イ)〜(よこいと)(ぬき)
鮪	(キ)(ユウ)(イ)〜(まぐろ)(しび)
未	(ミ)(ビ)〜(いま・だ)(ま・だ)(ひつじ)『いまだし
未申	ひつじさる
位	(イ)〜(くらい)(ぐらい)(ぞき)『くらゐ『ヰ
味	(ミ)〜(あじ)(あじ・わう)『あぢ『うま『ビ
味噌水	うづ『みそうず
畏	(イ)〜(おそ・れる)(かしこ・まる)(かしこ)(かしこ・し)『かしく『ヰ
畏れ	おそれ
胃	(イ)『ヰ
尉	(イ)(ジョウ)『ヰ
渭	(イ)
蔚	(ウツ)(イ)〜(うち)(おとこよもぎ)
磑	(ガイ)〜(う・す)
蝟	(イ)〜(はりねずみ)『ヰ
衛	〔衞〕衛。(エイ)(エ)〜(もり)(い)(まもる)『まもり『ヱ『ヱイ
慰	(イ)〜(なぐさ・める)(なぐさ・む)『なぐさ『ヰ
衞	〔衞〕衛。(エイ)(エ)〜(まも・る)(まもり)(まもる)『ヱ『ヱイ
謂	(イ)〜(い・う)(いい)(おも・う)(いわゆる)『いひ
魏	(ギ)〜(たか・い)
温	{溫}温。(オン)〜(あたた・か)(あたた・かい)(あたた・まる)(あたた・める)(ぬく)(あつ)(あつし)(なお)(はる)(ゆ)(ゆたか)『ウンṬ『ぬくい『ヲン
溫	{溫}温。あたたか『あたたかい『あたたまる『あたためる『ウンṬ『オン『ぬく『ぬくい『ヲン
榲	(オツ)
瘟	(オン)〜(えやみ)
饂	(ウン)〜(うどん)
鰛	(オン)〜(いわし)
鰮	(オン)〜(いわし)
亠	(トウ)〜(なべぶた)
文	(ブン)(モン)〜(ふみ)(あや)(かざり)(ふ)(も)(ぶんにょう)
文蛤	はまぐり
蚊	(ブン)〜(か)『か
蚊母樹	いすのき
紋	(モン)〜(あや)
馼	(ブン)(モン)
聞	(ブン)(モン)〜(き・く)(き・こえる)
刎	(フン)〜(は・ねる)(くびは・ねる)『はね
吻	(フン)(ブン)〜(くちわき)(くちさき)
紊	(ビン)(ブン)〜(みだ・れる)
穏	〔穩〕穏。(オン)〜(おだ・やか)『ヲン
穩	〔穩〕穏。(オン)〜(おだ・やか)『ヲン
問	(モン)〜(と・う)(と・い)(とん)(はる)
翁	(オウ)〜(おきな)(お)(おな)『ヲウ
鶲	(ひたき)
蓊	(オオ)(オウ)〜(とう)
瓮	{甕}瓮。(オオ)(オウ)〜(もたい)『へ『もたひ
甕	{甕}瓮。(オウ)〜(かめ)(みか)(もたい)『たしらか『へ『みかわ『もたひ
倭	(ワ)(イ)〜(したが・う)(まさ)(やす)(やまと)
堝	(カ)〜(るつぼ)
萵	(ワ)
渦	(カ)『うず『うづ『クヮ
窩	(カ)(ワ)〜(むろ)『クヮ
蝸	(カ)〜(かたつむり)
我	(ガ)〜(われ)(わ)(わ・が)(わが)(あ)(あが)(か)『あれ『わぬ『わろ
沃	(ヨウ)(ヨク)(オク)〜(そそ・ぐ)『エウ
臥	(ガ)〜(ふせ・る)(ふ・せる)(ふ・す)『グヮ
握	(アク)〜(にぎ・る)
幄	(アク)〜(とばり)『あげばり
渥	(アク)〜(あつ・い)(うるお・う)(あつし)
斡	(アツ)(カン)(ワツ)〜(めぐ・る)(めぐ・らす)
齷	(アク)
污	{污}汚。オ『きたない『けがす『けがらわしい『けがれる『よごす『よごれる『ヲ
巫	(フ)〜(みこ)(かんなぎ)『かう『かみなぎ『かむなぎ『きね『こうなぎ
巫鳥	しとど
巫覡	きね
屋	(オク)〜(や)(た)『ヲク
烏	(ウ)(オ)〜(からす)(いずくんぞ)(なんぞ)『ヲ
烏滸	おこ『をこ
嗚	(ウ)(オ)〜(ああ)『ヲ
嗚呼	ああ
誣	(フ)〜(しい・る)(し・いる)(あざむ・く)『ブ
无	{無}无。(ブ)(ム)〜(なし)(ない)(むにょう)(む)(なし)
毋	(ブ)(ム)〜(はは)(ぼ)(ない)(なか・れ)(なかれ)(かんのはは)
吾	(ゴ)〜(われ)(わが)(あ)(あ)(あが)『あれ『わ『わぬ
吳	{吳}呉。くれ『くれる『ゴ
呉	{吳}呉。(ゴ)〜(く・れる)(くれ)(ぐ)
茣	(ゴ)
茣蓙	ござ
唔	(ゴ)
珸	(ゴ)
梧	(ゴ)〜(あおぎり)
無	{無}无。(ム)(ブ)〜(な・い)『なみする
蜈	(ゴ)
蕪	(ブ)(ム)〜(かぶ)(かぶら)(あれる)
蕪菁	かぶ『かぶら
鵐	(ブ)(ム)『しとど
五	(ゴ)〜(いつ)(いつ・つ)(い)(さ)(さつ)(ち)(ふ)(み)(め)『ウー『ぐ
午	(ゴ)〜(うま)
伍	(ゴ)〜(いつつ)(くみ)(あつむ)
忤	(ゴ)〜(さから・う)(もと・る)
武	(ブ)(ム)〜(たけ・し)(う)(お)(たけし)(たけん)(ん)
侮	〔侮〕侮。(ブ)〜(あなど・る)(あなず・る)
牾	(ゴ)
舞	(ブ)〜(ま・う)(ま・う)(まい)『まひ
廡	(ブ)〜(しげ・る)(ひさし)
憮	(ブ)(コ)〜(いつくし・む)
儛	まい『まひ
錻	(ブ)
鵡	(ブ)(ム)
兀	(コツ)
勿	(モチ)(ブツ)(ボツ)〜(なか・れ)(なし)『まな
戊	(ボ)(ボウ)〜(つちのえ)
物	(ブツ)(モツ)〜(もの)(もの)『ものする『もん
物食み	ものはみ
悟	(ゴ)〜(さと・る)
務	(ム)〜(つと・める)(つかさ)(み)『つとまる
晤	(ゴ)〜(あきらか)
塢	(オ)(ウ)
誤	(ゴ)〜(あやま・る)(あやま・る)
寤	(ゴ)〜(さ・める)
霧	(ム)(ボウ)(ブ)〜(きり)
鶩	(ボク)(ブ)(ム)〜(あひる)
夕	(セキ)〜(ゆう)(ゆ)『しゃく『ゆふ
兮	(ケイ)
西	(セイ)(サイ)(ス)〜(にし)(いり)(ひし)(むら)
吸	(キュウ)〜(す・う)『キフ
汐	(セキ)〜(しお)(うしお)(せい)(いそ)『しほ
希	(キ)(ケ)〜(まれ)(のぞ)(のぞみ)『こいねがう『ねがう
昔	(セキ)(シャク)〜(むかし)
析	(セキ)
唏	(キ)〜(なげ・く)
息	(ソク)〜(いき)『いこう『おき『むすこ『やすむ『やむ
息子	むすこ
奚	(ケイ)〜(なんぞ)
晞	(キ)〜(かわ・く)
欷	(キ)〜(なげく)
悉	(シツ)(シチ)〜(つ・きる)(ことごと)(ことごと・く)(つ・くす)(つぶさ・に)
淅	(セキ)
渓	{溪}渓。(ケイ)〜(たに)(たにがわ)
惜	(セキ)〜(お・しい)(お・しむ)『あたら『あったら『シャク
晰	(シャク)(セキ)〜(あきらか)
稀	(キ)(ケ)〜(まれ)(まばら)
翕	(キュウ)〜(あ・う)
犀	(サイ)(セイ)
皙	(シャク)(セキ)〜(しろ・い)
溪	{溪}渓。(ケイ)〜(たに)(たにがわ)
煕	(キ)〜(たのし・む)(ひか・る)(ひろ・い)(よろこ・ぶ)(かわ・く)(あきらか)(ひろ・める)(ひろ・まる)(おき)(ひろし)
熙	(キ)〜(たのし・む)(ひか・る)(ひろ・い)(よろこ・ぶ)(かわ・く)(あきらか)(ひろ・める)(ひろ・まる)
蜥	(シャク)(セキ)〜(とかげ)
熈	(キ)〜(たのし・む)(ひか・る)(ひろ・い)(よろこ・ぶ)(かわ・く)(あきらか)(ひろ・める)(ひろ・まる)
僖	(キ)〜(よろこ・ぶ)
熄	(ソク)〜(き・える)(や・む)
膝	(シツ)〜(ひざ)『ひざ
膝行	いざり『ゐ
嬉	(キ)〜(うれ・しい)(たの・しむ)(うらし)(うれし)
熹	(キ)〜(あぶ・る)(あかるい)(あきら)
錫	(セキ)(シャク)〜(すず)(たま・う)
歙	(キュウ)(キョウ)(ショウ)〜(す・う)
羲	(ギ)(キ)
蟋	(シツ)
犠	〔犧〕犠。(ギ)(キ)〜(いけにえ)
谿	{溪}谿。(ケイ)〜(たに)(たにがわ)
鯑	(かずのこ)
醯	(ケイ)(カイ)
曦	(ギ)(キ)
犧	〔犧〕犠。(ギ)(キ)〜(いけにえ)
席	(セキ)〜(むしろ)
習	(シュウ)(ジュ)〜(なら・う)(なら・い)『シフ『ジフ『ジュウ『ならわし
蓆	(セキ)〜(むしろ)
媳	よめ
覡	(ゲキ)(ケキ)〜(かんなぎ)(みこ)『かう『かみなぎ『かむなぎ『こうなぎ
隰	(シツ)(シュウ)〜(さわ)
檄	(ケキ)〜(げき・する)(ふれぶみ)『ゲキ
襲	(シュウ)〜(おそ・う)(かさ・ね)(そい)『おすい『おすひ『おそい『おそひ『くだり『シフ
洗	(セン)〜(あら・う)(あらい)(らい)
枲	からむし
枲の垂れ衣	むしのたれぎぬ
枲麻	むし
徙	(シ)〜(うつ・る)(うつ・す)
喜	(キ)〜(よろこ・ぶ)(よろこ・ばす)(あき)(きゅ)(のぶ)(ゆき)(よし)
銑	(セン)『ずく『つく『づく
憙	(キ)〜(よろこ・ぶ)(ああ)(この・む)
橲	(ツサ)
禧	(キ)〜(さいわ・い)
璽	(ジ)
鱚	(きす)
匸	(ケイ)〜(かくしがまえ)
系	(ケイ)
盻	(ケイ)〜(にら・む)
咥	(テツ)(キ)〜(か・む)
係	(ケイ)〜(かか・る)(かかり)(がかり)(かか・わる)
郤	(ゲキ)(キャク)(ケキ)
細	(サイ)〜(ほそ・い)(ほそ・る)(こま・か)(こま・かい)『ささ『ささら『さざれ『ほそ
細魚	さより
細枝	しもと
隙	(ゲキ)(キャク)(ケキ)〜(すき)(す・く)(す・かす)(ひま)
禊	(ケイ)(カツ)〜(みそぎ)(はら・う)
戯	{戲}戯。(ギ)(ゲ)〜(たわむ・れる)(ざ・れる)(じゃ・れる)『あじゃら
潟	(セキ)〜(かた)(がた)(がら)『かた
繋	(ケイ)〜(つな・ぐ)(かか・る)(か・ける)『つながる
戲	{戲}戯。(ギ)(ゲ)〜(たわむ・れる)(たわむ・れ)『あじゃら『ざれる
鬩	(ケキ)(カク)(ゲキ)〜(せめ・ぐ)
谺	(コ)(カ)〜(こだま)
瞎	(カツ)〜(めくら)(かため)
蝦	(カ)(ゲ)〜(えび)(えみ)『かえる『かへる
蝦虎魚	はぜ
蝦蟇	{蝦蟆}蝦蟇。がま
蝦蟆	{蝦蟆}蝦蟇。がま
鰕	(カ)〜(えび)
匣	(コウ)〜(はこ)
侠	{俠}侠。(キョウ)〜(きゃん)(おとこだて)『ケフ
狎	(オウ)(コウ)〜(な・れる)(あなど・る)
峡	{峽}峡。(キョウ)(コウ)〜(はざま)(き)(ば)『かい『かひ『ケフ
俠	{俠}侠。きゃん『キョウ『ケフ
狭	{狹}狭。(キョウ)(コウ)〜(せま・い)(せば・める)(せば・まる)(さ)(はざ)『ケフ『せ
陜	(キョウ)(コウ)〜(せま・い)
峽	{峽}峡。(キョウ)(コウ)〜(はざま)(かい)『かひ『ケフ
狹	{狹}狭。(キョウ)(コウ)〜(せま・い)(せば・める)(せば・まる)(さ)『ケフ『せ
遐	(カ)〜(とお・い)(なんぞ)(とお)
瑕	(カ)〜(あら)(きず)(なんぞ)
暇	(カ)〜(ひま)(いとま)
轄	(カツ)〜(くさび)
霞	(カ)(ゲ)〜(かすみ)(かす・む)
鍜	(カ)
黠	(カツ)〜(さと・い)(わるがしこ・い)
下	(カ)(ゲ)〜(した)(しも)(もと)(さ・げる)(さ・がる)(くだ・る)(くだ・り)(くだ・す)(くだ・す)(くだ・さる)(お・ろす)(お・りる)(さか)(しと)
下鞍	したぐら
下部	しもべ
下沓	うづ『したうず『したうづ『しとうず
圷	(あくつ)
夏	(カ)(ガ)(ゲ)〜(なつ)
梺	(ふむと)(ふもと)
嚇	(カク)〜(おど・かす)『おどす
罅	(カ)(ケ)〜(ひび)(すき)(もたい)
仙	(セン)(セント)〜(そま)(のり)
先	(セン)〜(さき)(ま・ず)(ぽん)『さっき
掀	(キン)(ケン)
僊	(セン)
銛	(セン)(テン)〜(もり)(すき)
暹	(セン)
鮮	(セン)〜(あざ・やか)『すくない
繊	{纖}繊。(セン)
孅	(セン)〜(かよわ・い)
纎	(セン)
纖	{纖}繊。(セン)
弦	{弦}絃。(ゲン)〜(つる)『いと
咸	(カン)(ゲン)〜(みな)(しげ)
胘	みげ
涎	(セン)(エン)〜(よだれ)『ゼン『よだり
舷	(ゲン)〜(ふなべい)(ふなばた)『ふなべり
絃	{弦}絃。(ゲン)〜(いと)『つる
閑	(カン)〜(が)(より)『しずか『のど『ひま
啣	(カン)〜(くわ・える)(くつわ)
嫌	(ケン)(ゲン)〜(きら・う)(きら・い)(いや)『や
銜	(カン)〜(くつわ)
賢	(ケン)〜(かしこ・い)(かた)(さか)(さと)(さとし)(たか)(たて)(のり)(まこと)(まさ)(まさる)『かしこ『さかしい
嫻	(カン)〜(なら・う)(みやびやか)
嫺	(カン)〜(なら・う)(みやびやか)
癇	(カン)〜(ひきつけ)
険	{險}険。(ケン)〜(けわ・しい)『さが『さがし
筅	(セン)〜(ささら)
尠	(セン)(セウ)〜(すくな・い)
跣	(セン)〜(はだし)
跣足	はだし
蜆	(ケン)〜(しじみ)
險	{險}険。(ケン)〜(けわ・しい)『さが『さがし
嶮	{險}嶮。(ケン)〜(けわ・しい)
燹	(セン)〜(のび)
顕	{顯}顕。(ケン)〜(あきらか)(あらわ・れる)(あき)(あきら)『あらは『あらわ『あらわす
蘚	(セン)〜(こけ)
顯	{顯}顕。(ケン)〜(あきらか)(あらわ・れる)『あらは『あらわ『あらわす
限	(ゲン)〜(かぎ・る)(かぎ・り)(かぎ・り)『きり
県	〔縣〕県。(ケン)〜(か・ける)(あがた)(がた)
俔	(ケン)〜(たと・える)(うかが・う)
陥	〔陷〕陥。(カン)〜(おちい・る)(おとしい・れる)
陷	〔陷〕陥。(カン)〜(おちい・る)(おとしい・れる)
現	(ゲン)〜(あらわ・れる)(あらわ・す)(あきら)(きら)『あら『うつし『うつつ『おつつ『をつつ
献	{獻}献。(ケン)(コン)〜(たてまつ・る)『ささげる
腺	(セン)
羨	(セン)(エン)〜(うらや・む)(あまり)『うらやましい
綫	(セン)〜(すじ)
線	(セン)〜(すじ)
縣	〔縣〕県。(ケン)〜(か・ける)(あがた)(がた)
餡	(アン)(カン)
憲	(ケン)〜(かず)(のり)(よし)
霰	(セン)(サン)〜(あられ)
獻	{獻}献。(ケン)(コン)〜(たてまつ・る)『ささげる
相	(ソウ)(ショウ)〜(あい)(あ)(い)(おう)(さ)(さが)(すけ)『あひ『こもごも『サウ『シャウ『シヤウ
香	(コウ)(キョウ)〜(か)(かお・り)(かお・る)(こ)(こお)(ひゃん)(よし)『カウ『かぐわしい『かざ『かんばしい『キャウ『キヤウ『こり
香蒲	がま
香気	{香氣}香気。かざ
香氣	{香氣}香気。かざ
香魚	あゆ
郷	{鄉}郷。(キョウ)(ゴウ)〜(さと)(くに)『ガウ『キャウ『キヤウ
鄉	{鄉}郷。ガウ『キャウ『キヤウ『キョウ『ゴウ『さと
廂	(ショウ)(ソウ)〜(ひさし)(ひさ)
湘	(ショウ)
鄕	{鄉}鄕。キョウ『ゴウ
箱	(ソウ)〜(はこ)『サウ『はこ
襄	(ジョウ)(ショウ)〜(はら・う)
驤	(ジョウ)(ショウ)〜(あ・がる)
庠	(ショウ)〜(まなびや)
祥	〔祥〕祥。(ショウ)〜(あき)(さか)(さち)(ひろ)(まさ)(やす)(ゆき)(よし)『きざし『さが『シャウ『シヤウ
翔	(ショウ)〜(かけ・る)(と・ぶ)(か)『かけり『シャウ
詳	(ショウ)〜(くわ・しい)(つまび・らか)(よし)『シャウ
享	(キョウ)(コウ)〜(う・ける)(たか)(たかし)(とおる)(みち)『キャウ
想	(ソウ)(ソ)〜(おも・う)『サウ
餉	(ショウ)〜(け)(かれい)(かれい・い)(べんとう)『いひ『かれひ
饗	(キョウ)〜(う・ける)(もてな・す)(あい)(あえ)『あう『あへ『キャウ『キヤウ
響	〔響〕響。(キョウ)〜(ひび・く)『キャウ『とよむ
鱶	(ショウ)(ヨウ)〜(ふか)(ひもの)
向	(コウ)〜(む・く)(む・い)(む・き)(む・ける)(む・け)(む・かう)(む・かい)(む・こう)(む・こう)(むこ)(むか・い)(こお)(た)(な)(むか)(むかい)(むこう)『カウ『キャウ『キョウ『さきに
巷	(コウ)〜(ちまた)『カウ
象	(ショウ)(ゾウ)〜(かたど・る)(きさ)『ザウ『シャウ『シヤウ
項	(コウ)〜(うなじ)『うな『カウ『たてくび
像	(ゾウ)〜(かた)『ザウ
橡	(ショウ)(ゾウ)〜(とち)(くぬぎ)『つるばみ『とちのき『どんぐり
嚮	(コウ)(キョウ)〜(さきに)(むか・う)『カウ『キャウ『さき
肖	(ショウ)〜(あやか・る)『セウ『にる
逍	(ショウ)
恷	(キュウ)
消	(ショウ)〜(き・える)(け・す)『く『け『セウ
宵	(ショウ)〜(よい)『セウ『よひ
梟	(キョウ)〜(ふくろ・う)『ケウ『さけ『ふくろふ
梟帥	たける
硝	(ショウ)『セウ
霄	(ショウ)〜(そら)『セウ
銷	(ショウ)(ソウ)〜(け・す)(と・ける)(かわ・す)(とろ・かす)『セウ
蕭	(ショウ)〜(よもぎ)『セウ
彇	はず
鵁	(コウ)
簫	(ショウ)〜(ふえ)『セウ
瀟	(ショウ)
囂	(ゴウ)(キョウ)〜(かしま・しい)(かまびす・しい)『ガウ『かま
驍	(ギョウ)(キョウ)〜(たけし)
淆	(コウ)〜(ま・じる)
小	(ショウ)〜(ちい・さい)(こ)(お)(さ)(いさら)(こう)(さざ)(しゃお)(ちいさ)『ささ『セウ『を
小鉤	こはぜ
暁	{曉}暁。(ギョウ)(キョウ)〜(あかつき)(さと・る)(あき)(あきら)(あけ)(さと)(さとる)(てる)『あかとき『ゲウ『さとす
筱	(ゾウ)(ショウ)〜(しの)
曉	{曉}暁。(キョウ)(ギョウ)〜(あかつき)(さと・る)(あき)『あかとき『ゲウ『さとす
篠	(ゾウ)(ショウ)〜(しの)(ささ)(の)『しぬ『すず
孝	(コウ)(キョウ)〜(たか)(たかし)(のり)(よし)『カウ『ケウ
効	{效}効。(コウ)〜(き・く)(ききめ)(なら・う)『かい『カウ『かひ
咲	{笑}咲。(ショウ)〜(さ・く)(ざき)(さ)(さき)『さく
校	(コウ)(キョウ)〜(めん)『カウ『ケウ
哮	(コウ)〜(た・ける)(ほ・える)
笑	{笑}咲。(ショウ)〜(わら・う)(え・む)(えみ)『さく『セウ
效	{效}効。(コウ)〜(き・く)(ききめ)(なら・う)『かい『カウ『かひ
傚	(コウ)〜(なら・う)
嘯	(ショウ)(シツ)〜(うそぶ・く)『うそ『うそふき『セウ
些	(サ)(シャ)〜(ち・と)(ち・っと)(いささか)
楔	(ケツ)(セツ)〜(くさび)(ほうだて)
歇	(ケツ)(カイ)(カツ)〜(や・める)
蝎	(カツ)〜(さそり)(すくもむし)
蠍	(カツ)〜(さそり)
邪	(ジャ)〜(よこし・ま)『か『ヤ
協	(キョウ)『ケフ
恊	(キョウ)〜(あわ・せる)(かな・う)
挾	〔挾〕挟。(キョウ)(ショウ)〜(はさ・む)(はさ・まる)(わきばさ・む)(さしはさ・む)(はざ)『ケフ
脇	(キョウ)〜(わき)(わけ)『かたわら『ケフ『わき
脅	(キョウ)〜(おびや・かす)(おど・す)(おど・かす)『ケフ
偕	(カイ)〜(ともに)
斜	(シャ)〜(なな・め)(はす)
携	{攜}携。(ケイ)〜(たずさ・える)(たずさ・わる)
頡	(ケツ)(キツ)(カツ)(ケチ)
鞋	(アイ)(カイ)〜(わらじ)(くつ)
諧	(カイ)〜(かな・う)(やわ・らぐ)
襭	(ケツ)〜(つまばさ・む)(はさ・む)
攜	{攜}携。(ケイ)〜(たずさ・える)(たずさ・わる)
纈	(ケツ)(ケチ)〜(しぼり)(ぶさ)『ゆはた
写	〔寫〕写。(シャ)(ジャ)〜(うつ・す)(うつ・る)(うつ)(うつ・し)
冩	(シャ)〜(うつ・す)(うつ・る)
寫	〔寫〕写。(シャ)〜(うつ・す)(うつ・る)
泄	(セツ)(エイ)〜(も・れる)
卸	(シャ)〜(おろ・す)(おろし)(おろ・し)『おろす
洩	(エイ)(セツ)〜(も・らす)(の・びる)(も・れる)
屑	(セツ)〜(くず)(いさぎよ・い)『くづ
屓	(キ)
械	(カイ)〜(かせ)
紲	(セツ)〜(きずな)『づな
渫	(セツ)(チョウ)〜(さら・う)
緤	(セツ)(セチ)〜(きずな)(つな・ぐ)
薤	(カイ)〜(らっきょう)(にら)
邂	(カイ)〜(あ・う)
廨	(カイ)(ケ)〜(やくしょ)
懈	(ケ)(カイ)〜(たわ・い)(おこた・る)
謝	(シャ)〜(あやま・る)(さ)(ざ)
燮	(ショウ)〜(やわ・らげる)
褻	(セツ)〜(けが・れる)(な・れる)『け
瀉	(シャ)〜(くだ・す)(は・く)(だか)『そそぐ
蠏	(カイ)〜(かに)
蟹	(カイ)〜(かに)
心	(シン)〜(こころ)(ごころ)(りっしんべん)『うら『けけれ『ここり
芯	(シン)
辛	(シン)〜(から・い)(つら・い)(づら・い)(かのと)
辛螺	にし
辛夷	こぶし
忻	(キン)〜(よろこ・ぶ)
欣	(キン)(ゴン)(コン)〜(よろこ・ぶ)(よろこ・び)(やすし)(よし)(し)
新	(シン)〜(あたら・しい)(あら・た)(あら)(にい)(あせ)(あたらし)(し)(に)(にっ)(につ)(よし)『さら『にひ
薪	(シン)〜(たきぎ)(まき)
噺	(はなし)
馨	(ケイ)(キョウ)〜(かお・る)(かおり)(か)(かおる)(きよ)(よし)(かほる)『キャウ
鐔	(タン)(シン)〜(つば)『つみは
信	(シン)〜(し)(しが)(しな)(しの)(しぶ)(とき)(のび)(のぶ)(まこと)
釁	(キン)〜(ちぬ・る)(すき)(ひま)
星	(セイ)(ショウ)〜(ほし)(ぼし)『シャウ
猩	(ショウ)(セイ)(ソウ)〜(しょうじょう)
惺	(セイ)〜(さと・る)
腥	(セイ)(ショウ)〜(なまぐさ・い)
鮏	さけ
刑	(ケイ)〜(おさか)(ぎょう)『ギャウ
形	(ケイ)(ギョウ)〜(かた)(がた)(かたち)(なり)(ち)『ギャウ
型	(ケイ)〜(かた)(がた)
哘	(さそ・う)
裄	{絎}裄。(ゆき)
醒	(セイ)〜(さ・ます)(さ・める)
杏	(キョウ)(アン)(コウ)〜(あんず)(りょう)『キャウ
幸	{幸}倖。(コウ)〜(さいわ・い)(さち)(しあわ・せ)(こ)(さき)(さし)(さっ)(とも)(ひろ)(みゆき)(ゆ)(ゆき)(よし)『カウ『さいはひ
性	(セイ)(ショウ)〜(さが)『シャウ『シヤウ
姓	(セイ)(ショウ)『かばね『サウ『シャウ『シヤウ『そう
倖	{幸}倖。(コウ)〜(しあわ・せ)(さいわ・い)『カウ
興	(コウ)(キョウ)〜(おこ・る)(おこ・す)(おき)(おこっ)(とも)『おこし
凶	{凶}兇。(キョウ)
匂	{匈}匂。(にお・う)(にお・い)(にお・わせる)(おり)(こう)(さぎ)『におう
兄	(ケイ)(キョウ)〜(あに)(え)(せ)(よし)『キャウ
兇	{凶}兇。(キョウ)〜(おそ・れる)(わる・い)
匈	{匈}匂。(キョウ)『におう
洶	(キョウ)〜(わ・く)
恟	(キョウ)〜(おそ・れる)
胸	(キョウ)〜(むね)(むな)
胸掛	むながい『むなかき
胸繋	むながい『むなかき
胸懸	むながい『むなかき
雄	(ユウ)〜(お)(おす)(おん)(かつ)(たけ)(つよし)(ゆ)(よう)『をす『をん
熊	(ユウ)〜(くま)『くま
夐	(ケイ)(ケン)〜(はるか)
休	(キュウ)〜(やす・む)(やす・まる)(やす・める)『いこう『キウ
修	{修}脩。(シュウ)(シュ)〜(おさ・める)(おさ・まる)(おき)(なが)(のぶ)(おさむ)『シウ
烋	(コウ)(キュウ)(キョウ)
脩	{修}脩。(シュウ)〜(おさ・める)(なが・い)(ほじし)(おさむ)(おさ)(なが)(のぶ)(はる)『シウ
羞	(シュウ)〜(はじ・る)(すすめ・る)『シウ『はじ『はずかしい『はずかしめる『はぢ
貅	(キュウ)
鮴	(ゴリ)〜(めばる)(まて)(こち)
朽	(キュウ)〜(く・ちる)(くつ)『キウ
宿	(シュク)〜(やど)(やど・る)(やど・す)(すく)(ぶすき)(やけ)
秀	(シュウ)〜(ひい・でる)(しゅ)(しょう)(ひで)(ひでし)(ほ)『シウ
岫	(コウ)(シュウ)(ユウ)〜(みさき)(くき)(みね)
袖	(シュウ)〜(そで)『シウ
嗅	{嗅}嚊。(キュウ)〜(か・ぐ)『かか『かかあ『キウ
綉	(シュウ)(ツ)(トウ)
銹	{鏽}銹。(シュ)(シュウ)〜(さび)
嚊	{嗅}嚊。(ヒ)〜(かかめ)(かかあ)(はないき)『かか
繍	{繡}繍。(シュウ)〜(ぬいとり)『シウ
鏥	(シュウ)〜(さび)
繡	{繡}繍。シウ『シュウ『ぬいとり
鏽	{鏽}銹。さび
戌	(ジュツ)〜(いぬ)
戌亥	いぬい『ゐ
吁	(ク)(ウ)〜(ああ)
胥	(ショ)(ソ)〜(あい)(み・る)(みな)
虚	{虛}虚。(キョ)(コ)〜(むな・しい)(うつ・ろ)『うそ『うつ『うつお『うつけ『うつせ『うつほ『うろ『から『そら『むな
虛	{虛}虚。うそ『うつ『うつお『うつけ『うつせ『うつほ『うつろ『うろ『から『キョ『コ『そら『むな『むなしい
須	(ス)(シュ)〜(すべから・く)(すべし)(ひげ)(まつ)(もち・いる)(もと・める)(もとむ)(ぞ)
墟	(キョ)〜(あと)
需	(ジュ)『もとめる
嘘	{噓}嘘。(キョ)(コ)〜(うそ)(ふ・く)
歔	(キョ)〜(すすりな・く)
噓	{噓}嘘。うそ
鬚	(シュ)(ス)〜(ひげ)
徐	(ジョ)〜(おもむ・ろに)『おもむろ
栩	(ク)〜(くぬぎ)
糈	しとぎ
旭	(キョク)〜(あさひ)(あきら)(あき)(てる)(ひ)
序	(ジョ)〜(つい・で)(ついで)(つぐ)
叙	{敘}叙。(ジョ)〜(つい・ず)(ついで)『のべる
洫	(キョク)〜(みぞ)
恤	(ジュツ)(シュツ)〜(めぐ・む)(あわ・れむ)(うれ・える)
勗	(キョク)(ボウ)〜(つと・める)
敍	{敘}敍。(ジョ)〜(つい・ず)(ついで)『のべる
敘	{敘}叙。(ジョ)〜(つい・ず)(ついで)『のべる
壻	{婿}壻。(セイ)〜(むこ)
絮	(ジョ)(ショ)〜(わた)
婿	{婿}壻。(セイ)〜(むこ)『もこ
蓄	(チク)〜(たくわ・える)
煦	(ク)〜(あたた・める)
続	{續}続。(ゾク)(ショク)(コウ)(キョウ)〜(つづ・く)(つづ・ける)(つぐ・ない)(つぐ)
聟	{婿}聟。(セイ)〜(むこ)
緒	〔緖〕緒。(ショ)(チョ)〜(お)(いとぐち)(ほ)『を
緖	〔緖〕緒。お『ショ『チョ
續	{續}続。(ゾク)(ショク)(コウ)(キョウ)〜(つづ・く)(つづ・ける)(つぐ・ない)(つぐ)(つづき)
蓿	(シュク)
宣	(セン)〜(のたむ・う)(のたま・わく)(とおる)(のぶ)(のぼる)(のり)(ひさ)(よし)『のたまう『のべる『のる
宣り言	のりごと
軒	(ケン)〜(のき)
萱	(ケン)〜(かや)(かんぞう)(か)
喧	(ケン)〜(やかま・しい)(かまびす・しい)
愃	(ケン)(カン)
暄	(ケン)〜(あたたか・い)
煖	(ダン)(カン)(ケン)(ナン)〜(あたた・か)(あたた・める)『あたたかい
諠	(ケン)〜(かまびす・しい)(わす・れる)(みつぐ)
玄	(ゲン)〜(くろ)(けん)(はる)(はるか)『くろい
痃	(ゲン)(ケン)
旋	(セン)『めぐる
旋風	つむじ
旋毛	つじ
懸	(ケン)(ケ)〜(か・ける)(か・かる)
懸（け）橋	かけはし
懸け樋	かけい『かけひ『ひ
選	(セン)〜(えら・ぶ)『える『よる
癬	(セン)〜(たむし)
炫	{炫}衒。ゲン『てらう
眩	(ゲン)(カン)〜(げん・す)(くるめ・く)(まぶ・しい)(くら・む)(まど・う)(めま・い)『くらます『まばゆい
衒	{炫}衒。(ゲン)(ケン)〜(てら・う)
絢	(ケン)(ジュン)〜(あや)
鉉	(ケン)〜(つ・る)
鐶	(カン)〜(たまき)(わ)『クワン
削	(サク)〜(けず・る)(はつ・る)(そ・ぐ)(げ)
削ぎ	そぎ
靴	(カ)〜(くつ)『クヮ
薛	(セツ)
穴	(ケツ)〜(あな)(けな)(しし)(な)『めど
斈	(ガク)〜(まな・ぶ)
学	{學}学。(ガク)〜(まな・ぶ)(たか)(のり)
學	{學}学。(ガク)〜(まな・ぶ)(さとる)
鴬	(オウ)〜(うぐいす)
鷽	(カク)(アク)〜(うそ)(ざき)
雪	(セツ)〜(ゆき)(せっ)(ぶき)『すすぐ『そそぐ『よき
膤	(セツ)〜(そり)
艝	(そり)
轌	(そり)
鱈	(セツ)〜(たら)
血	(ケツ)〜(ち)『ケチ『のり
謔	(ギャク)(キャク)〜(たわむ・れる)
塤	{塤}壎。けん
熏	{熏}燻。(クン)〜(くす・べる)(ふす・べる)(いぶ・す)(いぶ・る)(くす・ぶる)(くゆ・らす)
勲	{勳}勲。(クン)〜(いさお)(いさむ)『いさおし『いさを
薫	{薰}薫。(クン)〜(かお・る)(かおり)(かおる)(かほ)(かほる)(くに)(しげ)(にほ)(のぶ)(よし)
勳	{勳}勲。(クン)〜(いさお)(いさ)『いさおし『いさを
壎	{塤}壎。けん
薰	{薰}薫。かおる『クン
燻	{熏}燻。(クン)〜(くす・べる)(ふす・べる)(いぶ・す)(いぶ・る)(くす・ぶる)(くゆ・らす)
醺	(クン)〜(よう)
旬	(ジュン)(シュン)
巡	(ジュン)〜(めぐ・る)(めぐ・り)
荀	(ジュン)(シュン)
洵	(ジュン)(シュン)〜(の・ぶ)(まこと・に)『まこと
恂	(ジュン)(シュン)〜(まこと)
循	(ジュン)『したがう
尋	(ジン)〜(たず・ねる)(ひろ)(ず)(つぐ)
詢	(ジュン)(シュン)〜(はか・る)(まこと)『とう
潯	(ジン)〜(ふち)
迅	(ジン)『はやい
徇	(ジュン)(シュン)〜(あまねし)(したが・う)(とな・える)
殉	(ジュン)
訓	(クン)(キン)〜(おし・える)(よ・む)(くん・ずる)(く)(くに)(くの)(さとし)(のり)(ふみ)『おしえ『よみ
訊	(ジン)(シュン)(シン)〜(き・く)(と・う)(たず・ねる)
巽	(ソン)〜(たつみ)
馴	(ジュン)(シュン)(クン)〜(な・れる)(な・らす)(したが・う)
遜	(ソン)〜(したが・う)(へりくだ・る)(ゆず・る)
蕈	(ジン)(シン)〜(きのこ)(たけ)
濬	(シュン)〜(さら・う)
押	(オウ)〜(お・す)(お・し)(お・っ)(お・さえる)(おさ・える)(おし)(おす)(おや)『アフ
椏	(また)
鴉	(ア)〜(からす)
鴨	(オウ)〜(かも)(あひる)
壓	{壓}圧。(アツ)(エン)(オウ)〜(お・す)(へ・す)(おさ・える)
鐚	{錏}鐚。(ワ)(ア)〜(びた)(しころ)
牙	(ガ)(ゲ)〜(きば)(は)(きばへん)『かび『き
芽	(ガ)〜(め)(じ)(めぐ)『めぐむ
芽子	はぎ
厓	{崖}厓。がけ
崕	(ガイ)〜(がけ)
崖	{崖}厓。(ガイ)(ゲ)(ギ)〜(がけ)(きし)(はて)『まま
涯	(ガイ)〜(はて)
睚	(ガイ)〜(まなじり)
衙	(ガ)(ギョ)(ゴ)
唖	{啞}唖。(ア)(アク)〜(おし)
啞	{啞}唖。ア『おし
雅	(ガ)〜(みや・び)(う)(お)(か)(ただし)(のり)(まさ)(まさし)(よし)『みやびやか
襾	(ア)〜(け)(にし)
亜	〔亞〕亜。(ア)(アシア)〜(つ・ぐ)(や)(つぎ)(つぐ)
亞	〔亞〕亜。(ア)(アシア)〜(つ・ぐ)
軋	(アツ)〜(きし・る)(きし・む)
訝	(ガ)(ゲ)〜(いぶか・る)
錏	{錏}鐚。(ア)(エ)〜(しろこ)(しころ)『びた
呀	(ガ)(カ)〜(あ)
咽	(イン)(エン)(エツ)〜(むせ・ぶ)(むせ・る)(のど)(の・む)『のみと『のんど
烟	(エン)〜(けむ・る)(けむり)(けむ・い)『けぶ『けぶり『けむ
焉	(エン)〜(いずく・んぞ)(ここに)(これ)『いずくにか『なんぞ
淹	(エン)
湮	(イン)(エン)〜(しず・む)(ふさ・ぐ)
煙	(エン)〜(けむ・る)(けむり)(けむ・い)(たば)『けぶ『けぶい『けぶり『けむ
樮	(ほくそ)
嫣	(エン)
閹	(エン)(アン)〜(おお・う)
篶	(エン)〜(くろだけ)(すず)
臙	(エン)〜(のど)(べに)
延	(エン)〜(の・びる)(の・べる)(の・べ)(の・ばす)(たか)(のぶ)(のべ)『ひく
言	(ゲン)(ゴン)〜(い・う)(こと)(とき)
妍	(ケン)〜(うつく・しい)
岩	{岩}巌。(ガン)〜(いわ)『いは『いはほ『いわお
炎	(エン)〜(ほのお)(ぬく)『ほ『ほむら
沿	〔沿〕沿。(エン)〜(そ・う)(ぞ・い)
莚	(エン)〜(むしろ)
研	〔硏〕研。(ケン)〜(と・ぐ)(のり)『ゲン『みがく
硏	〔硏〕研。ケン『とぐ
蜒	(エン)(タン)
嵒	(ガン)〜(いわ)(けわ・しい)
筵	(エン)〜(むしろ)
塩	{鹽}塩。(エン)〜(しお)『しほ
閻	(エン)
厳	{嚴}厳。(ゲン)(ゴン)〜(おごそ・か)(きび・しい)(いか・めしい)(いつくし)(いつ)(いづ)(きゅうら)(とし)
檐	(エン)(タン)〜(のき)(ひさし)
顏	{顏}顔。(ガン)〜(かお)『がお『かほ『がほ『かんばせ
顔	{顏}顔。(ガン)〜(かお)『がお『かほ『がほ『かんばせ
嚴	{嚴}厳。(ゲン)(ゴン)〜(おごそ・か)(きび・しい)(いか・めしい)(いつくし)『いつ
巌	{岩}巌。(ガン)〜(いわ)(いわお)(けわ・しい)(よし)『いは『いはほ
簷	(エン)〜(ひさし)『のき
巖	{岩}巖。(ガン)〜(いわ)(いわお)(けわ・しい)(よし)
鹽	{鹽}塩。(エン)〜(しお)『しほ
奄	(エン)〜(おお・う)(たちまち)(あま)
衍	(エン)〜(あまり)(しく)(はびこ・る)『あまる
掩	(エン)〜(おお・う)
菴	{庵}菴。(アン)〜(いおり)(いお)『いほ『いほり
眼	(ガン)(ゲン)〜(まなこ)(め)
偃	(エン)〜(ふ・せる)
罨	(アン)(エン)〜(あみ)
演	(エン)『のべる
厴	へた
儼	(ゲン)〜(いかめ・しい)(おごそか)
魘	(エン)(ヨウ)〜(うな・される)
黶	(アン)(エン)〜(ほくろ)『あざ
彥	{彥}彦。ゲン『ひこ
彦	{彥}彦。(ゲン)〜(ひこ)(よし)(こ)(ひろ)(やす)
晏	(アン)〜(おそ・い)
宴	{宴}讌。(エン)〜(うたげ)(うた)(やす)
偐	(ゲン)(ガン)
焔	{焰}焔。(エン)〜(ほのお)『ほ『ほむら
堰	(エン)〜(せき)(せ・く)『い『いせき『ゐ
硯	(ケン)(ゲン)〜(すずり)
雁	{雁}鴈。(ガン)〜(かり)(かりがね)
焰	{焰}焔。エン『ほ『ほのお『ほむら
鳫	(ガン)〜(かり)(かりがね)
厭	(エン)(オン)(アン)(オウ)(ユウ)(ヨウ)〜(いや)(あ・きる)(いと・う)(おさ・える)『エフ『や
鴈	{雁}鴈。(ガン)〜(かり)(かりがね)
燕	(エン)〜(つばめ)(つばくら)(つばくろ)『つばくらめ
諺	(ゲン)〜(ことわざ)
験	{驗}験。(ケン)(ゲン)〜(あかし)(しるし)(ため・す)(ためし)
贋	{贗}贋。(ガン)〜(にせ)
嚥	(エン)〜(の・む)
艶	{艷}艶。(エン)〜(つや)(なま・めかしい)(あで・やか)(つや・めく)(なま・めく)(もろ)(よし)『あで
軅	(やがて)
贗	{贗}贋。ガン『にせ
驗	{驗}験。(ケン)(ゲン)〜(あかし)(しるし)(ため・す)(ためし)
讌	{宴}讌。(エン)〜(うたげ)
艷	{艷}艶。(エン)〜(つや)(なま・めかしい)(あで・やか)(つや・めく)(なま・めく)(よし)『あで
央	(オウ)〜(あきら)(え)(お)(さと)(ちか)(てる)(なか)(ひさ)(ひろ)(や)『アウ『なかば
泱	(オオ)(オウ)
殃	(オオ)(オウ)(ヨウ)〜(わざわい)『はひ
秧	(オウ)〜(なえ)
鞅	(オウ)(ヨウ)〜(むながい)『むなかき
鴦	(オウ)
羊	(ヨウ)〜(ひつじ)(よ)『ヤウ
佯	(ヨウ)〜(いつわ・る)
昜	(ヨウ)
洋	(ヨウ)〜(なだ)(ひろ)(ひろし)(よ)(よし)『ヤウ
陽	(ヨウ)〜(ひ)(あき)(あきら)(あけ)(はる)(ひろ)(やん)(よ)『ヤウ
揚	(ヨウ)〜(あ・げる)(あ・げ)(あ・がる)(あがり)『ヤウ
楊	(ヨウ)〜(かわ)(やなぎ)(やな)『ヤウ
暘	(ヨウ)
煬	(ヨウ)〜(あぶ・る)(や・く)
瘍	(ヨウ)〜(かさ)
仰	(ギョウ)(コウ)〜(あお・ぐ)(おお・せ)(お・っしゃる)(おっしゃ・る)『カウ『ガウ『ギャウ『ギヤウ『ゴウ
痒	{癢}痒。(ヨウ)〜(かゆ・がる)(かさ)(かゆ・い)『ヤウ
養	(ヨウ)(リョウ)〜(やしな・う)(や)『ヤウ
瀁	(ヨウ)
癢	{癢}痒。(ヨウ)〜(かゆ・い)『ヤウ
怏	(オウ)(ヨウ)〜(うら・む)
恙	(ヨウ)〜(つつが・ない)『つつが
様	{樣}様。(ヨウ)(ショウ)〜(さま)(さん)『ざま『ためし『ヤウ
漾	(ヨウ)〜(ただよ・う)
樣	{樣}様。(ヨウ)(ショウ)〜(さま)『ざま『ためし『ヤウ
幺	(ヨウ)〜(ちいさい)(いとがしら)(ようへん)
夭	(ヨウ)(オウ)(カ)〜(わか・い)(わかじに)(わざわい)『エウ
妖	(ヨウ)〜(あや・しい)(なま・めく)(わざわ・い)『エウ『およずれ『およづれ
殀	(ヨウ)〜(わかじに)
腰	(ヨウ)〜(こし)(うすぐ)『エウ
邀	(ヨウ)〜(むか・える)(もと・める)
爻	(コウ)(ギョウ)〜(まじ・わる)(めめ)(まじわる)『カウ
尭	{堯}尭。(ギョウ)〜(たか・い)(たかし)(たか)(のり)(あき)『ゲウ
肴	{餚}肴。(コウ)〜(さかな)『カウ『な
姚	(ヨウ)(チョウ)〜(うつく・しい)
堯	{堯}尭。(ギョウ)〜(たか・い)『ゲウ
揺	{搖}揺。(ヨウ)〜(ゆ・れる)(ゆ・る)(ゆ・らぐ)(ゆ・るぐ)(ゆ・する)(ゆ・さぶる)(ゆ・すぶる)(うご・く)『エウ『ゆ
搖	{搖}揺。(ヨウ)〜(ゆ・れる)(ゆ・らぐ)(ゆ・るぐ)(ゆ・する)(ゆ・さぶる)(ゆ・すぶる)(うご・く)『エウ『ゆ『ゆる
徭	(ヨウ)(エウ)〜(えだち)(ふぞろ・い)(つかい)
遥	{遙}遥。(ヨウ)〜(はる・か)『エウ『はる
遙	{遙}遥。(ヨウ)〜(はる・か)『エウ『はる
瑶	〔瑤〕瑶。(ヨウ)〜(たま)『エウ
瑤	〔瑤〕瑶。(ヨウ)〜(たま)『エウ
銚	(チョウ)(ヨウ)〜(なべ)
蕘	(ジョウ)〜(たきぎ)(きこり)
嶢	(ギョウ)〜(けわ・しい)
窰	(ヨウ)〜(かま)
窯	(ヨウ)〜(かま)『エウ
餚	{餚}肴。カウ『コウ『さかな『な
謡	{謠}謡。(ヨウ)〜(うた・い)(うた・う)『うた『うたひ『エウ
謠	{謠}謡。(ヨウ)〜(うた・う)(うた)『うたい『うたひ『エウ
杳	(ヨウ)〜(くら・い)(はるか)『エウ
咬	(コウ)(ヨウ)〜(か・む)
窈	(ヨウ)
要	(ヨウ)〜(い・る)(かなめ)(とし)『エウ『ぬみ『もとめる
要害	ぬみ
葯	{藥}葯。(ヤク)
薬	{藥}薬。(ヤク)〜(くすり)(み)『くす
藥	{藥}葯。(ヤク)〜(くすり)『くす
曜	(ヨウ)〜(てる)『エウ
燿	(ヨウ)〜(かがや・く)(ひかり)
耀	(ヨウ)〜(かがや・く)(ひかり)(あかる)『エウ
鷂	(ヨウ)〜(はいたか)『はしたか
鑰	(ヤク)〜(かぎ)
耶	(ヤ)(ジャ)〜(か)
掖	(エキ)〜(たす・ける)(わきばさ・む)『わき
椰	(ヤ)〜(やし)
噎	(イツ)(エツ)〜(む・せる)(むせ・ぶ)
揶	(ヤ)〜(からか・う)
爺	(ヤ)〜(じい)(じじい)(おやじ)(じじ)(ちち)『ぢい『ぢぢ『ぢぢい
也	(ヤ)(エ)〜(なり)(か)(また)(し)
冶	(ヤ)〜(い・る)(じ)
埜	(ヤ)(ショ)〜(の)
野	(ヤ)(ショ)〜(の)(の)(ずけ)(つけ)(ぬ)
野雁	のがん
叶	(キョウ)〜(かな・える)(かな・う)(かの)(かのう)
曳	(エイ)〜(ひ・く)(ひき)(びき)
曵	(エイ)〜(ひ・く)(びき)
夜	(ヤ)〜(よ)(よる)
頁	(ケツ)〜(ぺえじ)(おおが・い)(かしら)『ページ
液	(エキ)『つゆ
葉	(ヨウ)〜(は)(よ)(わ)『エフ『ショウ『セフ
腋	(エキ)(セキ)〜(わき)
楪	(チャ)
業	(ギョウ)(ゴウ)〜(わざ)(なり)(のぶ)『ゲフ『ゴフ
曄	(ヨウ)〜(かが・やく)(あき)
鄴	ぎょう『ゲフ
謁	〔謁〕謁。(エツ)『まみえる
鵺	(コウ)(ヤ)〜(ぬえ)
靨	(ヨウ)〜(えくぼ)『ゑ
一	(イチ)(イツ)〜(ひと)(ひと・つ)(かず)(い)(いっ)(いる)(かつ)(かづ)(てん)(はじめ)(ひ)(ひとつ)(まこと)『イー『ひい
一日	ついたち
一向	ひたぶる
弌	(イチ)(イツ)〜(ひと)(ひと・つ)(はじめ)(ひと)(ひとつ)
辷	(すべ・る)(すべ・らす)
伊	(イ)〜(かれ)(これ)(ただ)(よし)(いと)(だ)
衣	(イ)(エ)〜(ころも)(きぬ)(ぎ)『そ
衣袽	のみ
壱	{壹}壱。(イチ)(イツ)〜(ひとつ)(い)(かず)
医	{醫}医。(イ)〜(い・やす)(い・する)(くすし)
依	(イ)(エ)〜(よ・る)(よ)(より)
畩	(けさ)
猗	(イ)(ア)〜(ああ)
揖	(イツ)(ユ)(シュウ)(ユウ)〜(い)『イフ
壹	{壹}壱。(イチ)(イツ)〜(ひとつ)(い)
欹	(イ)(キ)〜(そばだ・てる)(そばだ・つ)
噫	(イ)(アイ)(オク)〜(ああ)(おくび)
醫	{醫}医。(イ)〜(い・やす)(い・する)(くすし)
夷	(イ)〜(えびす)(えみし)(ころ・す)(たい・らげる)(し)
沂	(ギ)(キ)(ギン)
怡	(イ)〜(よろこ・ぶ)
宜	(ギ)〜(よろ・しい)(よろ・しく)(き)(たか)(のぶ)(のり)(よし)『うべ『むべ
姨	(テイ)(イ)〜(いもと)(いもうと)(おば)
袘	ふき
萓	(ギ)
移	(イ)〜(うつ・る)(うつ・す)
釶	(シ)
痍	(イ)〜(きず)
貽	(イ)〜(おく・る)
詒	(イ)(タイ)〜(あざむ・く)
飴	(イ)(シ)〜(あめ)(やしな・う)『たがね
銕	(テツ)〜(くろがね)
疑	(ギ)〜(うたが・う)
遺	(イ)(ユイ)『のこす『わすれる『ヰ
儀	(ギ)〜(のり)(よし)
頤	(イ)〜(おとがい)(あご)『おとがひ
嶬	(ギ)
彜	(イ)〜(つね)
嶷	(ギョク)(ギ)〜(さと・い)
鮧	えそ
彞	{彞}彝。い
彝	{彞}彝。(イ)〜(つね)
乙	(オツ)(イツ)〜(おと)(きのと)『めり
已	(イ)〜(や・む)(すで・に)(のみ)(はなはだ)(み)
以	(イ)〜(もっ・て)(もち)
苡	(イ)(シ)(ワ)〜(くさ)
矣	(イ)
倚	(イ)(キ)〜(よ・る)(たの・む)
椅	(イ)
礒	(ギ)(ガ)〜(いそ)(いわお)
蟻	(ギ)〜(あり)
艤	(ギ)〜(ふなよそおい)
靉	(アイ)(イ)
乂	(ガイ)(カイ)(ゲ)〜(おさ・める)(か・る)
弋	(ヨク)〜(いぐるみ)(しきがまえ)
刈	(ガイ)(カイ)〜(か・る)(かっ)(かり)『かる
屹	(キツ)〜(そばだ・つ)
亦	(エキ)(ヤク)〜(また)
抑	(ヨク)〜(おさ・える)『そも『そもそも
苅	(ガイ)(カイ)〜(か・る)(かり)(かる)(かん)
杙	(ヨク)〜(くい)『くいぜ『くひ『くひぜ
邑	(ユウ)〜(うれ・える)(くに)(むら)(お)(おう)(おお)(おおざと)『イフ『おおざる『おほ
佚	(イツ)(テツ)〜(たのし・む)(のが・れる)
役	(ヤク)(エキ)〜(ちゃく)『え『えだち
易	(エキ)(イ)〜(やさ・しい)(やす・い)『かえる『かわる『ヤク『やす
奕	(エキ)(ヤク)
疫	(エキ)(ヤク)『え『えやみ
衵	(ジツ)〜(あこめ)
羿	げい
益	〔益〕益。(エキ)(ヤク)〜(ま・す)(まし)(ます)『ますます『ヤウ『よう
益益	ますます
悒	(ユウ)〜(ふさ・ぐ)(うれ・える)
異	(イ)〜(こと)(こと・なる)(け)
逸	〔逸〕逸。(イツ)〜(そ・れる)(そ・らす)(はぐ・れる)(いっ)(はや)(へん)『イチ『はやる
訳	〔譯〕訳。(ヤク)〜(わけ)
翊	(ヨク)
翌	(ヨク)
軼	(イツ)(テツ)〜(すぎ・る)
絏	(セツ)
肄	(イ)〜(なら・う)
詣	(ケイ)(ゲイ)〜(けい・する)(まい・る)(いた・る)(もう・でる)
裔	(エイ)〜(すそ)『すえ
意	(イ)〜(もと)(よし)『おもい『おもう『こころ
義	(ギ)〜(ただし)(ちか)(のり)(よし)
溢	(イツ)〜(こぼ・れる)(あふ・れる)(み・ちる)
駅	〔驛〕駅。(エキ)『うまや
蜴	(エキ)
億	(オク)〜(お)
誼	(ギ)〜(よしみ)(よい)
毅	(キ)(ギ)〜(つよ・い)(つよし)(こわし)(たけし)(たけ)(はたす)(あつし)(つよ)(とし)(み)
殪	(エイ)〜(たお・す)
螠	ゆむし
劓	はなきり
懌	(エキ)〜(よろこ・ぶ)
憶	(オク)『おもう
縊	(イ)(エイ)〜(くび・る)(くび・れる)
檍	(オク)〜(い)
翳	(エイ)〜(かげ)(かげ・る)(かざ・す)(きぬがさ)(くも・る)(くもり)『さしは
臆	(オク)(ヨク)〜(むね)(おくする)
翼	(ヨク)〜(つばさ)『たすける
藝	〔藝〕芸。(ゲイ)(ウン)〜(う・える)(のり)(わざ)
鎰	(イツ)〜(かぎ)
鶍	いすか
鯣	(エキ)〜(するめ)
繹	(エキ)(ヤク)〜(たずね・る)(ぬ・く)
饐	(イ)(エイ)(エツ)〜(す・える)(むせ・ぶ)
譯	〔譯〕訳。(ヤク)〜(わけ)
議	(ギ)〜(かた)(のり)『はかる
囈	(ゲイ)
鷁	(ゲキ)
懿	(イ)〜(よい)
驛	〔驛〕駅。(エキ)『うまや
因	(イン)〜(よ・る)(ちな・む)(て)『よし『よすが
茵	(イン)〜(しとね)
音	(オン)(イン)(ノン)〜(おと)(ね)(お)(と)
姻	(イン)
氤	(イン)
殷	(イン)(アン)〜(さかん)
陰	(イン)〜(かげ)(かげ・る)『オン『ほと
堙	(イン)〜(ふさ・ぐ)
蔭	(イン)(オン)〜(かげ)
慇	(イン)
吟	(ギン)
垠	(ギン)(ゴン)〜(きし)(さか・い)
崟	(ギン)〜(みね)
淫	(イン)〜(ひた・す)(ほしいまま)(みだ・ら)(みだ・れる)(みだり)
寅	(イン)〜(とら)(とも)(のぶ)
婬	(イン)〜(みだれ)(ひた・す)(ほしいまま)(みだ・ら)(みだ・れる)
欽	(キン)(コン)〜(つつし・む)(よし)(ひとし)
銀	(ギン)〜(しろがね)(うん)(かな)(かね)
霪	(イン)
齦	(ギン)(コン)〜(はぐき)『はじし
尹	(イン)〜(おさ)(ただ・す)(ちか)『ヰン
引	(イン)〜(ひ・く)(ひ・き)(ひ・き)(び・き)(ひ・ける)(いな)(ひき)(ひけ)(びき)
蚓	(ズ)(イン)〜(みみず)
釿	(キン)『ちょうな『てうな
飲	〔飮〕飲。(イン)(オン)〜(の・む)(の・み)
飮	〔飮〕飲。(イン)(オン)〜(の・む)
隠	〔隱〕隠。(イン)(オン)〜(かく・す)(かく・し)(かく・れる)(かか・す)(よ・る)(お)(がくし)『こもる
隱	〔隱〕隠。(イン)(オン)〜(かく・す)(かく・れる)(よ・る)『こもる
齗	はじし
廴	(イン)〜(いんにょう)(えんにょう)
印	(イン)〜(しるし)(じるし)(しる・す)『かね
胤	(イン)〜(たね)(つぎ)(つぐ)(かず)
酳	(シン)(イン)
憖	(ギン)(キン)〜(なまじ・い)『じひ『なまじ
応	〔應〕応。(オウ)(ヨウ)(ノウ)〜(あた・る)(まさに)(こた・える)(お)(たか)(まさ)『いらえる
英	(エイ)〜(はなぶさ)(あ)(あい)(え)(すぐる)(はな)(ひ)(ひで)(よし)(ら)『ひいでる
珱	(エイ)(ヨウ)
桜	{櫻}桜。(オウ)(ヨウ)〜(さくら)(さ)(ろう)『アウ
桜皮	{櫻皮}桜皮。かには『かにわ
瑛	(エイ)(ヨウ)〜(あき)(あきら)(てる)(え)
霙	(エイ)(ヨウ)〜(みぞれ)
嬰	(エイ)〜(ふ・れる)(みどりご)(あかご)
膺	(ヨウ)(オウ)〜(むね)
罌	(オウ)(エイ)(ヨウ)〜(もたい)(ほとぎ)(かめ)
嚶	(オオ)(オウ)〜(な・く)
瓔	(エイ)(ヨウ)
櫻	{櫻}桜。(オウ)(ヨウ)〜(さくら)『アウ
櫻皮	{櫻皮}桜皮。かには『かにわ
鶯	(オウ)〜(うぐいす)『うぐひす
纓	(エイ)(ヨウ)
軈	(やがて)
鷹	(ヨウ)(オウ)〜(たか)
鸚	(オオ)(イン)(オウ)(ヨウ)
迎	(ゲイ)〜(むか・える)(むかえ)『ギャウ『ギョウ
盈	(エイ)〜(み・たす)(み・ちる)(みつ)
蛍	{螢}蛍。(ケイ)〜(ほたる)
営	〔營〕営。(エイ)〜(いとな・む)(いとな・み)
楹	(エイ)〜(はしら)
塋	(エイ)〜(はか)
蝿	(ヨウ)〜(はえ)(はい)
瑩	(エイ)
螢	{螢}蛍。(ケイ)〜(ほたる)
營	〔營〕営。(エイ)〜(いとな・む)(いとな・み)
蠅	(ヨウ)〜(はえ)(はい)『はひ『はへ
瀛	(エイ)〜(うみ)
贏	(エイ)〜(あまり)
郢	(エイ)
影	(エイ)〜(かげ)『ヤウ『ヨウ
潁	(エイ)
頴	(エイ)〜(ほさき)(のぎ)(え)(かい)
穎	(エイ)〜(ほさき)(のぎ)『かび
癭	こぶ
映	(エイ)〜(うつ・る)(うつ・す)(は・える)(ば・え)(あきら)(え)(てる)
硬	(コウ)〜(かた・い)『カウ
暎	(エイ)(ヨウ)〜(うつ・す)(うつ・る)(は・える)
應	〔應〕応。(オウ)(ヨウ)〜(あた・る)(まさに)(こた・える)『いらえる
佣	{佣}傭。やとう『ヨウ
庸	(ヨウ)〜(つね)(のぶ)(やす)
傭	{佣}傭。(ヨウ)(チョウ)〜(やと・う)(あた・い)(ひと・しい)
雍	(ヨウ)(ユ)〜(ふさ・ぐ)(やわら・ぐ)
慵	(ヨウ)(ショウ)〜(ものうい)
擁	(ヨウ)
壅	(ヨウ)〜(ふさ・ぐ)
廱	(ヨウ)〜(やわらぐ)
癰	(ヨウ)〜(はれもの)
永	(エイ)〜(なが・い)(え)(と)(のり)(ひさ)(ひさし)『なが『ヤウ『ヨウ
永久	とは『とわ
甬	(ヨウ)
咏	{詠}咏。(エイ)〜(よ・む)(うた・う)
泳	(エイ)〜(およ・ぐ)
怺	(こら・える)
俑	(ヨウ)(トウ)(ユウ)
勇	(ユウ)〜(いさ・む)(お)(はや)
勇魚	いさな
涌	(ユウ)(ヨウ)(ユ)〜(わ・く)
詠	{詠}咏。(エイ)〜(よ・む)(うた・う)(うた)(え)(ええ)『ながむ
湧	(ユウ)(ヨウ)(ユ)〜(わ・く)(わき)(わく)
蛹	(ヨウ)〜(さなぎ)
踊	{踴}踊。(ヨウ)〜(おど・る)『おどり
慂	(ヨウ)〜(すす・む)(すす・める)
踴	{踴}踊。(ヨウ)〜(おど・る)『おどり
鯒	(こち)
用	(ヨウ)〜(もち・いる)(たから)『ユウ
攸	(ユウ)〜(ところ)
幽	(ユウ)『イウ『かすか
悠	(ユウ)〜(ゆ)『イウ『はるか
憂	(ユウ)〜(うれ・える)(うれ・い)(う・い)(う・き)(ゆ)『イウ『ウ
優	(ユウ)(ウ)〜(やさ・しい)(すぐ・れる)(まさ・る)(ゆ)(よし)『イウ『やさ
尢	(オウ)〜(だいのまげあし)(もっとも)
尤	(ユウ)〜(もっと・も)(とが・める)『イウ
由	(ユ)(ユウ)(ユイ)〜(よし)(よ・る)『イウ
犹	(ジョウ)(ユウ)(ヨウ)〜(なお)
肬	(ユ)(ユウ)〜(いぼ)
油	(ユ)(ユウ)〜(あぶら)『イウ
疣	(ユ)(ユウ)〜(いぼ)
郵	(ユウ)『イウ
蚰	(ユウ)
猶	(ユウ)(ユ)〜(なお)『イウ『なほ
遊	{游}遊。(ユウ)(ユ)〜(あそ・ぶ)(あそ・ばす)(あす)(う)『イウ
游	{游}遊。(ユウ)(リュウ)〜(あそ・び)(あそ・ぶ)(およ・ぐ)『イウ『ユ
楢	(シュウ)(ユウ)〜(なら)
猷	(ユウ)(ヨウ)〜(はかりごと)(はか・る)
蕕	(ユウ)(ユ)
蝣	(ユウ)
友	(ユウ)〜(とも)(う)(ど)(ゆ)『イウ
有	(ユウ)(ウ)〜(あ・る)(あ)(あら)(あり)(ある)(くに)(なお)(ゆ)『イウ『たもつ『もつ
酉	(ユウ)〜(とり)(なが)(みのる)(ひよりのとり)(とりへん)『イウ
莠	(ユウ)〜(はぐさ)
牖	まど
䳑	あじ『あぢ
黝	(ユウ)〜(あおぐろ)
又	(ユウ)〜(また)(また)(また・の)(やす)『また『まった
右	(ウ)(ユウ)〜(みぎ)(あき)(すけ)『イウ『みぎり
幼	(ヨウ)〜(おさな・い)(うぶ)(わか)『いと『いとけない『エウ『おさな『をさ
佑	(ユウ)(ウ)〜(たす・ける)(すけ)(たすく)(ゆ)『イウ『じょう
侑	(ユウ)(ウ)〜(すす・める)(たす・ける)(あつむ)(すすむ)(ゆき)(ゆ)『イウ
柚	(ユ)(ユウ)(ジク)〜(ゆず)『イウ
囿	(ユウ)〜(その)
宥	(ユウ)〜(なだ・める)(ゆる・す)『イウ
祐	(ユウ)(ウ)〜(たす・ける)(すけ)(さち)(よし)(たすく)(ひろ)(ひろし)(まさ)『イウ
釉	(ユウ)〜(うわぐすり)『イウ
誘	(ユウ)(イウ)〜(さそ・う)(いざな・う)
鼬	(ユウ)(ユ)〜(いたち)
鼬鼠	いたち
込	{迂}込。(こ・む)(こ・む)(こ・み)(こ・み)(こ・める)(こみ)(ごめ)『こむ
迂	{迂}込。(ウ)『こむ『こめる
於	(オ)(ヨ)〜(おい・て)(お・ける)(ああ)(より)
紆	(ウ)〜(まが・る)(めぐ・る)
唹	(オ)
淤	(オ)(ヨ)〜(どろ)
于	(ウ)(ク)〜(ここに)(ああ)(おいて)(に)(より)(を)
汚	{污}汚。(オ)〜(けが・す)(けが・れる)(けが・らわしい)(よご・す)(よご・れる)(きたな・い)『ヲ
余	〔餘〕余。(ヨ)〜(あま・る)(あま・り)(あま・す)(あまる)『われ
余所	{餘所}余所。よそ
盂	(ウ)〜(はち)
臾	(ユ)(ヨ)(ヨウ)
禺	(グ)(グウ)〜(おながざる)
竽	う
舁	(ヨ)〜(か・く)
兪	(ツ)(トウ)(ユ)〜(しかり)
娛	{娛}娯。ゴ『たのしみ『たのしむ
娯	{娛}娯。(ゴ)『たのしみ『たのしむ
萸	(ユ)
魚	(ギョ)〜(うお)(さかな)(ざかな)(い)『いお『いを『うを『お『な『を
魚杈	ひし
隅	(グウ)〜(すみ)『すま
揄	(ヨウ)(ユウ)(ユ)
畭	(ヨ)(シャ)
嵎	(グウ)(グ)〜(くま)
逾	(ユ)〜(いよいよ)(こ・える)
腴	(ユ)〜(あぶら)(こえ・る)『つちすり
渝	(ユ)〜(かわ・る)
愉	(ユ)〜(たの・しい)(たの・しむ)(ゆう)
瑜	(ユ)
榆	{榆}楡。にれ
楡	{榆}楡。(ユ)〜(にれ)
虞	(グ)〜(おそれ)『おそれ
愚	(グ)〜(おろ・か)
漁	(ギョ)(リョウ)〜(あさ・る)『すなどる『レフ
蝓	(ユ)
餘	〔餘〕余。(ヨ)〜(あま・る)(あま・り)(あま・す)『われ
餘所	{餘所}余所。よそ
魣	かます
諛	(ユ)〜(へつら・う)(へつら・い)
踰	(ユ)(ヨウ)〜(こ・える)
覦	(ユ)〜(ねが・う)
輿	(ヨ)〜(かご)(こし)
歟	(ヨ)〜(や)(か)
鯲	(どじょう)
与	{與}与。(ヨ)〜(あた・える)(あずか・る)(くみ・する)(ともに)(とも)(ゆ)『か『と『むた『より
予	〔豫〕予。(ヨ)(シャ)〜(あらかじ・め)『かねて『われ
宇	(ウ)〜(いえ)(たか)(ひろ)(ひろし)『のき『やかす
羽	〔羽〕羽。(ウ)〜(は)(わ)(はね)(しゅう)(ば)『ぱ
雨	(ウ)〜(あめ)(あま)(さめ)
挧	(ウ)
俣	(また)(ばた)
禹	(ウ)
圄	(ゴ)(ギョ)〜(ひとや)
敔	ぎょ
圉	(ギョ)(ゴ)〜(うまか・い)(ひとや)
與	{與}与。(ヨ)〜(あた・える)(あずか・る)(くみ・する)(ともに)『か『と『むた『より
傴	(ク)(ウ)〜(かが・む)(せむし)
語	(ゴ)〜(かた・る)(かた・らう)『ギョ『ことば
窳	いしま
嶼	(ショ)〜(しま)
麌	(グ)(ゴ)〜(おじか)
齬	(ゴ)
玉	(ギョク)〜(たま)(たま)(だま)(おう)(だん)
芋	(ウ)〜(いも)『いも『うも
聿	(イチ)(イツ)〜(ふで)(ここに)(ふでづくり)
郁	{郁}欝。(イク)〜(あや)(かおる)(い)(か)(ふみ)(ゆう)『ウツ
育	(イク)〜(そだ・つ)(そだ・ち)(そだ・てる)(はぐく・む)(やす)
峪	(ヨク)〜(たに)
浴	(ヨク)〜(あ・びる)(あ・びせる)(えき)(さこ)
域	(イキ)『ヰキ
欲	{欲}慾。(ヨク)〜(ほっ・する)(ほ・しい)
馭	(ギョ)
硲	(はざま)(さこ)(はざ)
遇	(グウ)〜(あ・う)
喻	{喻}喩。たとえ『たとえる『ユ
喩	{喻}喩。(ユ)〜(たと・える)(さと・す)『たとえ
御	{御}禦。(ギョ)(ゴ)〜(おん)(お)(み)(う)『おおむ『おおん『おほ『ふせぐ
御調	みつぎ
御妻	みめ
飫	(ヨウ)(オ)(ヨ)〜(あき・る)
寓	(グウ)(グ)(ドウ)〜(ぐう・する)(かこつ・ける)(よ・せる)(よ・る)(かりずまい)
裕	(ユウ)〜(すけ)(のり)(ひろ)(ひろし)(やす)(ゆ)(ゆたか)
愈	{愈}癒。(ユ)〜(いよいよ)(まさ・る)『いえる『いやす『いよよ
愈々	いよいよ
誉	〔譽〕誉。(ヨ)〜(ほま・れ)(ほ・める)(え)(たか)(たけ)(ほまれ)(ほめ)(ほん)
預	(ヨ)〜(あず・ける)(あず・かる)『あらかじめ
毓	(イク)〜(そだ・つ)(そだ・てる)(はぐく・む)(りゅう)
獄	(ゴク)『ひとや
瘉	(ユ)〜(い・える)(いや・す)
嫗	(オオ)(ウ)(オウ)〜(あたた・める)(おうな)『おみな『おむな『おんな
墺	(オウ)(イク)〜(きし)『アウ
慾	{欲}慾。(ヨク)
豫	〔豫〕予。(ヨ)(シャ)〜(あらかじ・め)『かねて『われ
蕷	(ヨ)〜(いも)
閾	(シキ)(イキ)(キョク)(ヨク)〜(くぎり)(しきい)『しきみ『ヰキ
閼	(ア)(アツ)(エン)(ヨ)〜(とど・める)(ふさ・ぐ)
諭	(ユ)〜(さと・す)(ゆう)
燠	(ウ)(イク)(オウ)〜(おき)(あたたか・い)
鴪	(イツ)
礇	(イク)
禦	{御}禦。(ギョ)(ゴ)〜(ふせ・ぐ)
癒	{愈}癒。(ユ)〜(い・える)(いや・す)
譽	〔譽〕誉。(ヨ)〜(ほ・まれ)(ほ・める)
鬻	(イク)(シュク)〜(かゆ)(かい)(ひさ・ぐ)
鷸	(イツ)〜(しぎ)
欝	{郁}欝。(ウツ)(ウン)〜(うっ・する)(ふさ・ぐ)(しげ・る)
鬱	{郁}鬱。(ウツ)〜(うっ・する)(ふさ・ぐ)(しげ・る)
冤	(エン)『ヱン
渊	(エン)(カク)(コウ)〜(ふち)(かた・い)(はなわ)
渕	(エン)(カク)(コウ)〜(ふち)(かた・い)(はなわ)
寃	(エン)
淵	(エン)(カク)(コウ)〜(ふち)(かた・い)(はなわ)
鳶	(エン)〜(とび)(とんび)
鋺	(エン)〜(かなまり)『まがり『まり
鴛	(エン)(オン)〜(おし)(おしどり)
元	(ゲン)(ガン)〜(もと)(ちか)(はじめ)(はる)(ゆき)(よし)『グヮン
円	{圓}円。(エン)〜(まる・い)(まる)(まど)(まど・か)(まろ・やか)(つぶら)(のぶ)(まどか)(みつ)『まろ『ヱン
芫	(ゲン)(ガン)
垣	(エン)〜(かき)(がい)『かき『ヱン
爰	(エン)〜(ここ・に)『ここ
袁	(エン)(オン)
原	(ゲン)〜(はら)(た)(ばる)(ら)(わた)(わら)『ばら『もと
員	(イン)〜(いな)(かず)『ヰン
援	(エン)『たすける『ひく『ヱン
湲	(エン)(カン)
媛	(エン)〜(ひめ)『ヱン
園	(エン)〜(その)(おん)(ぞの)『ヱン『ヲン
圓	{圓}円。(エン)〜(まる・い)(まる)(まど)(まど・か)(まろ・やか)(つぶら)『まろ『ヱン
猿	(エン)〜(さる)(さ)(さわ)(ざる)(まし)『ましら『ヱン
源	(ゲン)〜(みなもと)(はら)(みな)(もと)
縁	{緣}縁。(エン)(ネン)〜(ふち)(ふちど・る)(ゆかり)(よすが)(へり)(えにし)『えに『よる
緣	{緣}縁。えに『えにし『エン『ふち『へり『ゆかり『よすが『よる
薗	(エン)(オン)〜(ぞの)
轅	(エン)〜(ながえ)
櫞	(エン)
遠	(エン)(オン)〜(とお・い)(お)(おに)(ど)(どお)『おち『おと『ヱン『をち『をと『ヲン
苑	(エン)(オン)〜(その)(う・つ)(あや)『ヱン『ヲン
怨	(エン)(オン)(ウン)〜(うら・む)(うらみ)(うら・めしい)『ヱン『ヲン
院	(イン)『ヰン
掾	(エン)(テン)〜(じょう)
愿	(ゲン)〜(つつし・む)
願	(ガン)〜(ねが・う)(ねがい)(ら)『グヮン『グワン
曰	(エツ)〜(いわ・く)(のたま・わく)(ここに)(ひらび)
約	(ヤク)『つづまやか『つづめる
月	(ゲツ)(ガツ)〜(つき)(おと)(がっ)(す)(ずき)(もり)『がち『グワチ『グヮツ『つく
月隠り	つきこもり
月隱り	つきこもり
戉	(ジュウ)(エツ)〜(えびす)(まさかり)
刖	げつ
岳	{岳}嶽。(ガク)〜(たけ)(おか)(たか)(たけん)
悅	{悅}悦。エツ『よろこぶ
悦	{悅}悦。(エツ)〜(よろこ・ぶ)(よろこ・ばす)(や)(よし)
越	(エツ)(オツ)〜(こ・す)(こ・す)(ご・し)(こ・える)(ご・え)(えち)(えっ)(お)(こえ)(こし)(ごえ)(ごし)(ごや)『オチ『ヱチ『ヱツ『ヲチ
粤	{粵}粤。(エツ)〜(ここに)『ヱツ
楽	{樂}楽。(ガク)(ラク)(ゴウ)〜(たの・しい)(たの・しむ)(この・む)(さ)(た)(やす)(ら)
粵	{粵}粤。えつ『ヱツ
鉞	(エツ)〜(まさかり)『ヱツ
閱	{閱}閲。エツ『けみする
閲	{閱}閲。(エツ)〜(けみ・する)
樂	{樂}楽。(ガク)(ラク)(ゴウ)〜(たの・しい)(たの・しむ)(この・む)
樾	こむら
嶽	{岳}嶽。(ガク)〜(たけ)(たき)
龠	(ヤク)〜(ふえ)
躍	(ヤク)〜(おど・る)(おどり)
籥	(ヤク)〜(ふえ)
暈	(ウン)〜(ぼか・す)(ぼか・る)(かさ)(くま)(ぼかし)(めまい)
贇	(イン)
云	(ウン)〜(い・う)(ここに)
伝	〔傳〕伝。(デン)(テン)〜(つた・わる)(つた・える)(つた・う)(つだ・う)(づた・い)(つて)(つたえ)
芸	〔藝〕芸。(ゲイ)(ウン)〜(う・える)(のり)(わざ)(き)(げ)(なり)
耘	(ウン)〜(くさぎ・る)
紜	(ウン)〜(みだ・れる)
雲	(ウン)〜(くも)(ぐも)(き)(ずも)(のめ)
橒	きさ
繧	(ウン)
允	(イン)〜(じょう)(まこと・に)(ゆるす)(まこと)(のぶ)(まさ)(みつ)(すけ)(よし)(ちか)(とも)
隕	(イン)(エン)(ウン)〜(おち・る)『おとす『ヰン
殞	(イン)(ウン)〜(おち・る)(し・ぬ)
褞	(ウン)(オン)〜(ぬのこ)
孕	(ヨウ)〜(はら・む)(はらみ)(もと)
運	(ウン)〜(はこ・ぶ)『めぐらす『めぐる
韵	(イン)〜(ひびき)
慍	(ウン)(オン)〜(いか・る)(いか・り)(うら・む)
熨	(イ)(ウツ)〜(のし)(おさ・える)(の・す)(ひのし)
熨斗	のし
薀	(ウン)(オン)〜(たくわ・える)(つ・む)
蘊	(ウン)〜(つ・む)
韻	(イン)『ヰン
匝	(キョウ)(ソウ)〜(めぐ・る)
拶	(サツ)〜(せま・る)
拶双魚	さっぱ
魳	かます
雑	{雜}雑。(ザツ)(ゾウ)〜(まじ・える)(まじ・る)『ザフ『まざる『まぜる
襍	(ザツ)(ゾウ)〜(まじ・える)(まじ・る)
雜	{雜}雑。(ザツ)(ゾウ)〜(まじ・える)(まじ・る)(さい)『ザフ『まざる『まぜる
咋	(サク)(サクサ)〜(か・む)(く・う)(くら・う)(くい)
災	(サイ)〜(わざわ・い)
災い	はひ『わざわい
哉	(サイ)〜(かな)(や)(か)(すけ)(とし)(ちか)(はじめ)
栽	(サイ)
仔	(シ)〜(こ)(た・える)
宰	(サイ)〜(ただ)『みこともち
載	(サイ)〜(の・せる)(の・る)(とし)(のり)
再	(サイ)(サ)〜(ふたた・び)(ふた)
在	(ザイ)〜(あ・る)(あり)『います『まします『ます
縡	(サイ)〜(こと)
簪	(シン)(サン)〜(かんざし)
賛	{贊}賛。(サン)〜(たす・ける)(たた・える)『ほめる
暫	(ザン)〜(しばら・く)『しば『しばし
鏨	(サン)(ザン)〜(たがね)
贊	{贊}賛。(サン)〜(たす・ける)(たた・える)『ほめる
讃	(サン)〜(ほ・める)(たた・える)(さぬ)
讚	(サン)〜(ほ・める)(たた・える)
賍	(ソウ)
臧	(ゾウ)(ソウ)〜(よい)
贓	(ソウ)『ザウ『ゾウ
髒	{髒}臓。ザウ『ゾウ
弉	(ジョウ)(ソウ)〜(さかん)
奘	(ジョウ)(ソウ)〜(さかん)
葬	(ソウ)〜(ほうむ・る)(はふり)『サウ
臓	{髒}臓。(ゾウ)〜(はらわた)『ザウ
臟	{髒}臟。(ゾウ)〜(はらわた)『ザウ
遭	(ソウ)〜(あ・う)(あ・わせる)『サウ
糟	(コウ)(ソウ)〜(ぬか)(かす)『サウ
鑿	(サク)〜(のみ)(うが・つ)
早	(ソウ)(サッ)〜(はや・い)(はや)(はや)(はや・まる)(はや・める)(さ)(さか)(さわ)(そ)(わ)『サウ『はよ『わさ
早稲	{早稻}早稲。わさ
早稻	{早稻}早稲。わさ
早酒	わささ
蚤	(ソウ)〜(のみ)(はやい)
棗	(ソウ)〜(なつめ)
澡	(ソウ)〜(あら・う)
藻	(ソウ)〜(も)『サウ
繰	(ソウ)〜(く・る)(くり)『くる
皂	くり
灶	{灶}竈。かま『かまど『くど『ひ『へ『へつい『へっつい
造	(ゾウ)〜(つく・る)(つく・り)(づく・り)(ずくり)(づくり)(み)『ザウ『みやつこ
梍	(ユウ)
慥	(ゾウ)〜(たし・かに)
噪	(ソウ)〜(さわ・ぐ)
燥	(ソウ)〜(はしゃ・ぐ)『かわく『サウ
躁	(ソウ)〜(さわ・ぐ)『サウ
譟	(ソウ)〜(さわ・ぐ)
竈	{灶}竈。(ソウ)〜(かまど)(かま)(へっつい)『くど『ひ『へ『へつい
択	〔擇〕択。(タク)〜(えら・ぶ)
沢	{澤}沢。(タク)〜(さわ)(うるお・い)(うるお・す)(つや)(おも)(さ)(さわん)(わさ)『さは
則	(ソク)〜(のっと・る)(のり)『すなわち
責	(セキ)〜(せ・める)『シャク
嘖	(サク)〜(さいな・む)(さけ・ぶ)
幘	さく
擇	〔擇〕択。(タク)〜(えら・ぶ)
澤	{澤}沢。(タク)〜(さわ)(うるお・い)(うるお・す)(つや)『さは
簀	(サク)(ジャク)(セキ)〜(す)
仄	(ソク)〜(ほの・か)(ほの)(ほの・めかす)(ほの・めく)(かたむ・く)
昃	(ショク)(ソク)〜(かたむ・く)
戝	(ザイ)(サイ)(ゾク)
賊	(ゾク)
怎	(シン)(ソ)〜(いかで)(なんぞ)
譛	(シン)(セン)〜(そし・る)
譖	(シン)(セン)〜(そし・る)
囎	(ソ)〜(しょう)
増	{增}増。(ゾウ)〜(ま・す)(ま・し)(ふ・える)(ふ・やす)(まし)(ます)
增	{增}増。ゾウ『ふえる『ふやす『ます
憎	〔憎〕憎。(ゾウ)〜(にく・む)(にく・い)(にく・らしい)(にく・しみ)
鱛	えそ
甑	(ソウ)(ショウ)〜(こしき)
贈	〔贈〕贈。(ゾウ)(ソウ)〜(おく・る)
贈（り）名	おくりな
扎	(サツ)(アツ)
柤	(サ)〜(そ)
紮	(サツ)〜(からげる)
渣	(サ)
箚	(トウ)(サツ)(チョウ)〜(さ・す)
囃	(サツ)(ソウ)〜(はや・す)
札	(サツ)〜(ふだ)(さっ)『さね『ふみた『ふんだ
閘	(コウ)〜(ひのくち)
乍	(サ)(サク)〜(なが・ら)(たちま・ち)
柵	(サク)(サン)〜(しがら・む)(しがらみ)(とりで)(やらい)(ませ)(やな)『き
柞	(サク)〜(ははそ)『いす『いすのき『なら『はうそ『ほうそ
咤	(タ)(ト)〜(しか・る)
炸	(タク)(サ)(サク)
詐	(サ)〜(いつわ・る)『あざむく
搾	{榨}搾。(サク)〜(しぼ・る)
榨	{榨}搾。サク『しぼる
鮓	(サ)〜(すし)
粂	(くめ)
斎	{齋}斎。(サイ)〜(とき)(つつし・む)(ものいみ)(い・む)(いつき)(さえ)(ひとし)『い『いはひ『いみ『いもい『いもひ『いわい『ゆ
摘	(テキ)〜(つ・む)(つむ)『つまむ
齋	{齋}斎。(サイ)〜(つつし・む)(とき)(ものいみ)『い『いつき『いはひ『いみ『いもい『いもひ『いわい『ゆ
宅	(タク)〜(け)(たか)(たけ)(や)(やけ)『やか
窄	(サク)〜(すぼ・める)(つぼ・める)(せま・い)『すぼむ
砦	(サイ)〜(とりで)
債	(サイ)
寨	(サイ)〜(とりで)
沾	(セン)(チョウ)(テン)〜(うるお・う)(うるお・す)
栴	(セイ)(セン)〜(もみじ)
栴檀	せんだん
旃	(セン)〜(はた)
粘	(ネン)〜(ねば・る)『ねば
粘土	へな
霑	(テン)〜(うるお・う)(うるお・い)
氈	(セン)〜(もうせん)『かも
瞻	(セン)〜(み・る)
譫	(トウ)(セン)(タン)〜(うわごと)(たわごと)(うるさくしゃべ・る)
展	(テン)〜(のぶ)(のり)(ひろ)(ゆき)『のべる
斬	(ザン)(サン)(セン)(ゼン)〜(き・る)
盞	(サン)(セン)〜(さかずき)『うき
嶄	(ザン)(サン)
輾	(テン)(ネン)〜(きし・る)(めぐ・る)
占	(セン)〜(し・める)(うらな・う)(うら)(しむ)(じめ)
桟	{棧}桟。(サン)(セン)〜(かけはし)(さ)『えつり
站	(タン)
棧	{棧}桟。(サン)(セン)〜(かけはし)『えつり
湛	(タン)(チン)〜(しず・む)(たた・える)(かん)
戦	{戰}戦。(セン)〜(いくさ)(たたか・う)(おのの・く)(そよぐ)(わなな・く)(せ)
綻	(タン)〜(ほころ・びる)
戰	{戰}戦。(セン)〜(いくさ)(たたか・う)(おのの・く)(そよぐ)
章	(ショウ)〜(あき)(あきら)(あや)(ふみ)『シャウ
章魚	たこ
張	(チョウ)〜(は・る)(は・り)(ば・り)(はり)(わり)『チャウ『チヤウ
獐	のろ
彰	(ショウ)〜(あき)(あきら)『あらわす『シャウ
璋	(ショウ)
樟	(ショウ)〜(くす)『くすのき
鱆	(ショウ)〜(たこ)
麞	のろ
掌	(ショウ)〜(てのひら)(たなごころ)『シャウ『シヤウ『たなうら『つかさどる
漲	(チョウ)〜(みなぎ・る)『チャウ
丈	(ジョウ)〜(たけ)(だけ)(とも)(ますら)『たき『ヂャウ『ヂヤウ
仗	(ジョウ)(チョウ)〜(つえ)(つわもの)(まわり)(よる)『ヂャウ
杖	(ジョウ)〜(つえ)『ヂャウ『ヂヤウ『つゑ
帳	(チョウ)〜(とばり)『チャウ『チヤウ
脹	(チョウ)〜(は・れる)(ふく・らむ)(ふく・れる)『チャウ
障	(ショウ)〜(さわ・る)『シャウ
嶂	(ショウ)〜(みね)
瘴	(ショウ)
招	(ショウ)〜(まね・く)『セウ
昭	(ショウ)〜(あき)(あきら)(かず)(かずみ)(てる)『セウ
窼	{巢}窼。す
爪	(ソウ)〜(つめ)(つま)『サウ『つめ
找	(ソウ)
沼	(ショウ)〜(ぬま)『セウ『ぬ
召	(ショウ)〜(め・す)『セウ
兆	(チョウ)〜(きざ・す)(きざ・し)『テウ
笊	(ソウ)〜(ざる)(す)
棹	(トウ)(タク)〜(さお)(こ・ぐ)『さを
詔	(ショウ)〜(みことのり)(さとし)(のり)『セウ『のりごと
照	(ショウ)〜(て・る)(て・らす)(て・れる)(あき)(てる)『セウ
罩	(トウ)〜(こめ・る)
趙	(チョウ)(ジョウ)(キョウ)『テウ
肇	(チョウ)(ジョウ)(トウ)〜(はじ・める)(はじめ)(とし)(ただし)(はつ)『テウ
櫂	{桌}櫂。(トウ)(タク)〜(かい)(かじ)
遮	(シャ)〜(さえぎ・る)
折	(セツ)〜(お・る)(おり)(お・り)(お・り)(お・れる)(せき)『シャク
哲	(テツ)〜(あき)(あきら)(さと)(さとし)(さとる)(てっ)(てつん)(のり)(よし)
粍	(ミリメートル)〜(みり)
晢	(セイ)(セツ)〜(あきらか)
摺	(ショウ)(シュウ)(ロウ)〜(す・る)(ひだ)(する)(ずり)
輒	(チョウ・)〜(すなわち)(わきぎ・)
輙	(チョウ)〜(すなわち)(わきぎ)
磔	(タク)(チャク)〜(さ・く)(はりつけ)(ひらく)『はっつけ
蟄	(チツ)(チュウ)〜(ちっ・する)(かく・れる)
謫	(タク)(チャク)〜(せ・める)(とが・める)
轍	(テツ)〜(わだちい)(わだち)
者	〔者〕者。(シャ)〜(もの)『もん
赭	(シャ)〜(あかつち)『そお『そほ
褶	(ショウ)(シュウ)(チョウ)〜(かさね・る)『うは『うわも『しびら『ひらみ
柘	(シャ)(ジャク)〜(そ)(つげ)(やまぐわ)(つ)
這	(シャ)(ゲン)〜(は・う)(は・い)(むか・える)(この)『これ
浙	(セツ)
蔗	(シャ)(ショ)〜(さとうきび)
鷓	(シャ)
着	(チャク)(ジャク)〜(き・る)(ぎ)(き・せる)(き・せ)(つ・く)(つ・ける)『き『ヂャク
珍	(チン)〜(めずら・しい)(たから)(じん)『うず『うづ
珎	(チン)〜(めずら・しい)(たから)
貞	(テイ)〜(さだ)(さざ)(ただし)(りょう)『ジョウ『ただしい『ヂャウ
真	〔眞〕真。(シン)〜(ま)(ま)(まこと)(さな)(さね)(ただ)(ただし)(なお)(のり)(まあ)(まこ)(まさ)(まっ)(まど)(まな)(まゆ)(みち)(も)
真魚鰹	がつを『まながつお
砧	{砧}碪。(チン)〜(きぬた)
針	(シン)〜(はり)(は)
針孔	めど
針魚	さより
眞	〔眞〕真。(シン)〜(ま)(まこと)(さな)(ち)(まこ)(まさ)(まつ)
偵	{偵}遉。(テイ)『さすが
遉	{偵}遉。(テイ)〜(うかが・う)(さすが)
蓁	(シン)
斟	(シン)〜(く・む)
甄	(ケン)(シン)〜(すえ)
禎	(テイ)〜(さいわ・い)(ただ・しい)(さだ)(ただし)(よし)(さち)(とも)(のり)
榛	(シン)(ハン)〜(はしばみ)(はり)(はい)(はる)
槇	〔槇〕槙。(テン)(シン)〜(まき)(こずえ)
碪	{砧}碪。(チン)〜(きぬた)
箴	(シン)〜(いまし・める)(はり)『いましめ
臻	(シン)〜(いた・る)
鍖	(チン)
鍼	(シン)〜(はり)(さ・す)
枕	(チン)(シン)〜(まくら)『まくら
姫	(キ)〜(ひめ)(ひめ)『ひめ
畛	(シン)〜(あぜ)
疹	(シン)(チン)〜(はしか)
袗	(シン)
軫	(シン)〜(よこぎ)
診	(シン)〜(み・る)
陣	(ジン)『しきり『ヂン
振	(シン)〜(ふ・る)(ぶ・る)(ふ・り)(ぶ・り)(ふ・るう)(ふり)『ふれる
振り	ふり
朕	(チン)
賑	(シン)〜(にぎ・わい)(にぎ・やか)(にぎ・わす)(にぎ・わう)
震	(シン)〜(ふる・う)(ふる・える)
鴆	(チン)
鎮	〔鎭〕鎮。(チン)〜(しず・める)(しず・まる)(おさえ)(しげ)(じん)(ちか)『しず『しづ
鎭	〔鎭〕鎮。(チン)〜(しず・める)(しず・まる)(おさえ)
凧	(いかのぼり)(たこ)『いか
争	〔爭〕争。(ソウ)〜(あらそ・う)(いか・でか)『いかで『サウ
征	(セイ)〜(いく)(そ)(ただ)(まさ)(ゆき)『うつ『シチヤウ『しちょう『ゆく
爭	〔爭〕争。(ソウ)〜(あらそ・う)(いか・でか)『いかで『サウ
烝	(ジョウ)(ショウ)〜(む・す)(もろもろ)
崢	(ソウ)
筝	(ソウ)(ショウ)〜(こと)
蒸	(ジョウ)(セイ)〜(む・す)(む・れる)(む・らす)
鉦	(セイ)(ショウ)〜(かね)『シヤウ
箏	(ソウ)(ショウ)〜(こと)『サウ
徴	{徵}徴。(チョウ)(チ)〜(しるし)『しるまし『めす
錚	(ソウ)
癥	{癥}症。シャウ『シヤウ『ショウ
拯	(ショウ)(ジョウ)〜(すく・う)
掟	(トウ)(チョウ)(ジョウ)(テイ)〜(おきて)
整	(セイ)〜(ととの・える)(ととの・う)(ひとし)
正	(セイ)(ショウ)〜(ただ・しい)(ただ・す)(まさ)(まさ・に)(おお)(くに)(ま)(まさし)(ただし)『シャウ『シヤウ
正身	むざね
政	(セイ)(ショウ)〜(まつりごと)(まん)(ただ)(まさ)『シャウ
症	{癥}症。(ショウ)『シャウ『シヤウ
幀	(テイ)(チョウ)(トウ)『タウ
証	{證}証。(ショウ)〜(あかし)『あかす『しるし
諍	(ソウ)(ショウ)〜(いさか・う)(あらそ・う)(いさ・める)(うった・える)
鄭	(テイ)(ジョウ)
證	{證}証。(ショウ)〜(あかし)『あかす『しるし
之	(シ)〜(の)(これ)(おいて)(ゆく)(この)(ゆき)(いたる)(あき)(つな)(ゆみ)
支	(シ)〜(ささ・える)(つか・える)(か・う)(しんよう)(じゅうまた)
只	(シ)〜(ただ)
卮	{卮}巵。(シ)〜(さかずき)
汁	(ジュウ)〜(しる)(しる)(つゆ)『ジフ
芝	(シ)〜(しば)(こげ)(しは)『しば
巵	{卮}巵。(シ)〜(さかずき)
枝	(シ)〜(えだ)(え)(ぐさ)『よ
知	(チ)〜(し・る)(し・らせる)(さと)(さとる)(しり)(しれ)(とも)(のり)
肢	(シ)『あし『え
胝	(チ)〜(あかぎれ)『たこ
祗	(シ)〜(つつし・む)(まさに)
隻	(セキ)
脂	(シ)〜(あぶら)『やに
梔	(シ)〜(くちなし)
椥	(なぎ)
蜘	(チ)〜(くも)
織	(ショク)(シキ)〜(お・る)(お・り)(おり)(おり)(お・り)(こおり)(こり)(のり)
直	(チョク)(ジキ)(ジカ)〜(ただ・ちに)(なお・す)(なお・す)(なお・る)(なお・き)(す・ぐ)(すぐ)(なお)(のう)(のお)『あたい『あたえ『あたひ『あたへ『ただ『ヂカ『ヂキ『なほ『ね『ひた
侄	{侄}姪。めい『めひ
姪	{侄}姪。(テツ)(チツ)(ジチ)(イツ)(イチ)〜(めい)(おい)『めひ
值	{值}値。あたい『あたひ『チ『ね
値	{值}値。(チ)〜(ね)(あたい)(じ)『あたひ
埴	(ショク)〜(はに)(へな)
執	(シツ)(シュウ)〜(と・る)(し)『シフ
植	(ショク)〜(う・える)(う・わる)(うえ)(え)(げ)
殖	(ショク)〜(ふ・える)(ふ・やす)(うえ)(え)(げ)
跖	(セキ)〜(あしのうら)
稙	(ショク)(チョク)〜(たね)
職	(ショク)(ソク)〜(もと)『シキ
蹠	(セキ)〜(あしうら)(あしのうら)
躑	(テキ)〜(しゃが・む)(たちもとお・る)
夂	(チ)〜(しゅう)(ふゆがしら)
止	(シ)〜(と・まる)(ど・まり)(と・める)(と・める)(ど・め)(とど・める)(とど・め)(とど・まる)(や・める)(や・む)(や・む)(よ・す)(さ・す)(さ・し)(どめ)
凪	(なぎ)(な・ぐ)
旨	(シ)〜(むね)(うま・い)
阯	(シ)〜(あと)
址	(シ)〜(あと)
帋	(シ)〜(かみ)
沚	(シ)〜(なぎさ)
祉	〔祉〕祉。(シ)
指	(シ)〜(ゆび)(さ・す)(さ・し)(い)(いぶ)(さし)(さす)『おゆび『および
枳	(キ)(シ)〜(からたち)
咫	(シ)〜(た)『あた
𦨞	かはら『かわら
紙	(シ)〜(かみ)
紙鳶	いか『いかのぼり
紙凧	たこ
趾	(シ)〜(あと)(はや・い)
黹	(チ)〜(ぬう)(ぬいとり)(ふつ)
徵	{徵}徴。しるし『しるまし『チ『チョウ『めす
至	(シ)〜(いた・る)(のぶ)(のり)(みち)(よし)
志	{志}誌。(シ)(シリング)〜(こころざ・す)(こころざし)(じん)(べ)(べし)(ゆき)『さかん『しるす
豸	(タイ)(チ)〜(むじなへん)
帙	(チツ)〜(ふまき)
制	{制}製。(セイ)
炙	(シャ)(セキ)〜(あぶ・る)
治	(ジ)(チ)〜(おさ・める)(おさ・まる)(なお・る)(なお・す)(し)(ぢ)(はり)(はる)(みち)
峙	(ジ)〜(そばだ・つ)『ヂ
陟	(チョク)(トク)〜(すす・む)(のぼ・る)(たか)(のぼる)
桎	(シツ)〜(あしかせ)
致	{致}緻。(チ)〜(いた・す)
秩	(チツ)〜(ちち)(ちっ)
畤	(ジ)(シ)
貭	(シツ)(シチ)(チ)〜(たち)(ただ・す)(もと)(わりふ)
痔	(ヂ)(ジ)〜(しもがさ)
窒	(チツ)
蛭	(シツ)(チツ)〜(ひる)(えび)
智	(チ)〜(さと)(さとし)(さとる)(さとい)(とも)(のり)(とし)(あきら)(じ)(とみ)(ひと)(もと)(よも)
痣	(シ)〜(あざ)(ほくろ)
滞	〔滯〕滞。(タイ)(テイ)〜(とどこお・る)
輊	(チ)
置	(チ)〜(お・く)(お・き)(おき)(おけ)(き)
雉	(ジ)(チ)〜(きじ)(き)『きぎし『きぎす
雉子	きぎし『きぎす『きじ
稚	(チ)(ジ)〜(いとけない)(おさない)(おくて)(おでる)(まさ)(わか)(わく)(わっか)『やや『わかい
製	{制}製。(セイ・・)〜(・・・)
誌	{志}誌。(シ)『しるす
滯	〔滯〕滞。(タイ)(テイ)〜(とどこお・る)
摯	(シ)〜(いた・る)
幟	(シ)〜(のぼり)
質	(シツ)(シチ)(チ)〜(たち)(ただ・す)(もと)(わりふ)
膣	(チツ)
薙	{剃}薙。(テイ)(チ)〜(な・ぐ)(なぎ)(か・る)『か『ぐ『そ『な『なぎ『み『る
隲	(チョク)(シツ)〜(のぼ・る)
緻	{致}緻。(チ・)〜(こまか・い・)
擲	(テキ)(チャク)(ジャク)〜(なぐ・る)(なげう・つ)
櫛	(シツ)〜(くし)(くしけず・る)
穉	(チ)(ジ)〜(いと・けない)(おさ・ない)(おく・て)(お・ごる)
贄	(シ)〜(にえ)『にへ
鷙	(ゴウ)(シ)(チツ)
躓	(チ)〜(つまず・く)
中	(チュウ)〜(なか)(うち)(あた・る)(あたる)(かなえ)『ジュウẎ
忠	(チュウ)〜(きよし)(たた)(ただ)(ただし)(なお)『じょう
忠実	{忠實}忠実。まめ
忠實	{忠實}忠実。まめ
柊	(シュ)(シュウ)〜(ひいらぎ)『ひらぎ
衷	(チュウ)
終	(シュウ)〜(お・わる)(お・わる)(おわ・る)(お・える)(つい)(つい・に)(ばて)『つひ
鍾	(ショウ)(シュ)〜(あつ・める)(さかずき)(かね)
螽	(シュウ)〜(いなご)
鐘	(ショウ)〜(かね)『シュ
冢	{冢}塚。(チョウ)〜(つか)(おお・う)
尰	こい『こひ
塚	{冢}塚。(チョウ)〜(つか)(づか)(ずか)(つ)
腫	(シュ)(ショウ)〜(は・れる)(は・れ)(は・らす)(く・む)(はれもの)
種	(シュ)〜(たね)(ぐさ)(おい)(くさ)(た)(ほ)
踵	(ショウ)〜(かかと)(くび・す)(きび・す)(つ・ぐ)
仲	(チュウ)〜(なか)(ちゅん)(つづき)(なかつ)
狆	(チュウ)〜(ちん)
重	(ジュウ)(チョウ)〜(え)(おも・い)(おも・り)(おも・なう)(かさ・ねる)(かさ・なる)(おも)(さね)(しげ)(しげる)『ヂュウ『ヂユウ『へ
重ね	かさね
重り	おもり
眾	{眾}衆。シュ『シュウ
衆	{眾}衆。(シュウ)(シュ)〜(おお・い)
舟	(シュウ)〜(ふね)(ふな)(ぶね)『シウ
州	(シュウ)(ス)〜(す)(くに)『シウ
周	{周}週。(シュウ)〜(まわ・り)(あまね)(しゅ)(す)(ちか)(のり)(ひろ)(びび)(まこと)『あまねし『シウ
洲	(シュウ)(ス)〜(しま)『シウ『ひじ
矪	くるり
週	{周}週。(シュウ)『シウ
粥	(イク)(シュク)(ジュク)〜(かゆ)(かい)(ひさ・ぐ)
駲	(シュウ)(シュン)
軸	(ジク)『ヂク『よこがみ
肘	(チュウ)〜(ひじ)『チウ『ひじ『ひぢ
菷	(シュウ)(ソウ)〜(ほうき)
箒	{帚}箒。(ソウ)(シュウ)〜(ほうき)『はうき『ははき
呪	{咒}呪。(ジュ)(シュ)(シュウ)〜(まじな・う)(のろ・い)(まじな・い)(のろ・う)
咒	{咒}呪。(ジュ)(シュ)(シュウ)〜(まじな・う)(のろ・い)(まじない)(のろ・う)
宙	(チュウ)〜(ひろ)(ゆ)『チウ
冑	{胄}冑。(チュウ)〜(かぶと)(よろい)『チウ
胄	{胄}冑。(チュウ)〜(かぶと)(ちすじ)(よつぎ)『チウ
昼	{晝}昼。(チュウ)〜(ひる)『チウ
紂	(チュウ)〜(しりがい)『チウ
酎	(チュウ)(チュ)〜(かも・す)『チウ
晝	{晝}昼。(チュウ)〜(ひる)『チウ
甃	(シュウ)〜(しきがわら)(いしだたみ)『がはら
皺	(シュウ)(スウ)〜(しわ)(しぼ)『さび
籀	(チュウ)(シュウ)(ジュ)〜(よ・む)
驟	(シュウ)〜(にわか)(はせ・る)
帚	{帚}箒。(ソウ)(シュウ)〜(ほうき)『はうき『ははき
朱	(シュ)〜(あけ)(あ)(あか)(あき)(す)
朱鷺	とき
侏	(シュ)
茱	(シュ)
洙	(シュ)
珠	(シュ)〜(たま)(す)(とも)(ま)(み)
株	(シュ)〜(かぶ)『かぶ『くい『くいぜ『くひ『くひぜ
猪	{豬}猪。(チョ)〜(い)(いのしし)(いの)『しし『ゐ
猪の子	いのこ『ゐ
蛛	(チュ)(シュ)
誅	(チュウ)(チュ)〜(ちゅう・する)(ころ・す)(せ・める)
銖	(シュ)
潴	(チョ)〜(みずたまり)
豬	{豬}猪。(チョ)〜(い)(いのしし)『しし『ゐ
豬の子	いのこ『ゐ
諸	〔諸〕諸。(ショ)〜(もろ)『これ『もろもろ
諸々	もろもろ
藷	(ショ)(ジョ)〜(いも)
瀦	(チョ)〜(みずたまり)(ずま)
櫧	かし
竹	(チク)〜(たけ)(たか)
竹の子	たけのこ
竹柏	なぎ
竹叢	たかむら
竹席	{竹蓆}竹席。たかむしろ
竹蓆	{竹蓆}竹席。たかむしろ
竹莚	たかむしろ
竺	(ジク)(チク)(トク)〜(あつし)
逐	(チク)『おう
舳	(ジク)(チク)(チュウ)〜(へ)(へさき)(とも)『ヂク『みよし
燭	(ソク)(ショク)〜(ともしび)
燭魚	はたはた
躅	(チョク)(タク)
主	(シュ)(ス)(シュウ)〜(ぬし)(おも)(あるじ)(かず)(ず)(もん)『にし
渚	(ショ)〜(なぎさ)(なぎ)
煮	〔煮〕煮。(シャ)〜(に・る)(に)(に・える)(に・やす)
嘱	{囑}嘱。(ショク)〜(しょく・する)(たの・む)
麈	(シュ)(ス)〜(おおじか)
囑	{囑}嘱。(ショク)〜(しょく・する)(たの・む)
矚	(ショク)(ソク)〜(み・る)
助	(ジョ)〜(たす・ける)(たす・かる)(す・ける)(すけ)
住	(ジュウ)(ヂュウ)(チュウ)〜(す・む)(す・まう)(ず・まい)(し)(じゅ)(すみ)『ヂユウ
住（み）家	すみか
住み処	すみか
住み處	すみか
佇	(チョ)〜(たたず・む)
苧	(チョ)〜(お)(からんし)(からむし)『むし『を
苧麻	からむし
苧桛	おがせ『を
杼	(チョ)(ショ)〜(ひ)(どんぐり)『とち
注	{注}註。(チュウ)〜(そそ・ぐ)(さ・す)(つ・ぐ)
注連	しめ
柱	(チュウ)〜(はしら)『じ『じゅう『ぢ『ヂユウ
祝	〔祝〕祝。(シュク)(シュウ)〜(いわ・う)(のり)(ほぎ)(ゆわい)『シウ『はふり『ほぐ
祝（い）	いはひ『いわい
祝（い）歌	いはひ『いわいうた
莇	(ジョ)〜(あさがら)(あざみ)
竚	(チョ)〜(たたず・む)
著	〔著〕著。(チョ)(チャク)〜(あらわ・す)(いちじる・しい)『ジャク『ヂャク『つく『つける
紵	(チョ)
貯	(チョ)〜(た・める)(たくわ・える)『たくわえ
筑	{築}筑。(チク)〜(つく)(づき)
註	{注}註。(チュウ)
墸	(チョ)
箸	(チョ)(チャク)〜(はし)『はし
駐	(チュウ)『とどまる『とどめる
鋳	〔鑄〕鋳。(チュウ)(イ)(シュ)(シュウ)〜(い・る)『チウ
築	{築}簗。(チク)〜(きず・く)(つい)(つき)(つく)(づき)『やな
鑄	〔鑄〕鋳。(チュウ)(シュ)(シュウ)〜(い・る)『チウ
抓	(ソウ)〜(つ・ねる)(つ・める)(つね・る)(つま・む)
専	{專}専。(セン)〜(もっぱ・ら)『たうめ『とうめ『もはら
專	{專}専。(セン)〜(もっぱ・ら)『たうめ『とうめ『もはら
塼	{磚}塼。せん
甎	{磚}甎。(セン)〜(しきがわら)(かわら)
磚	{磚}塼。(セン)〜(かわら)
転	{轉}転。(テン)〜(ころ・がる)(ころ・げる)(ころ・がす)(ころ・ぶ)(まろ・ぶ)(うたた)(うつ・る)『うたて『ころ
撰	(サン)(セン)〜(せん・する)(えら・む)(えら・ぶ)
篆	(テン)
賺	(タン)(レン)〜(すか・す)
轉	{轉}転。(テン)〜(ころ・がる)(ころ・げる)(ころ・がす)(ころ・ぶ)(まろ・ぶ)(うたた)(うつ・る)『うたて『ころ
饌	(セン)(サン)〜(そな・える)
囀	(テン)〜(さえず・る)
庄	{莊}庄。(ショウ)(ソ)(ソウ)(ホウ)〜(まさ)『サウ『シャウ
妝	{妝}粧。(ソウ)(ショウ)〜(よそお・う)『サウ『シャウ
荘	{莊}荘。(ソウ)(ショウ)(チャン)〜(ほうき)(おごそ・か)(そ)『サウ『シャウ
莊	{莊}庄。(ソウ)(ショウ)(チャン)〜(ほうき)(おごそ・か)『サウ『シャウ
装	〔裝〕装。(ソウ)(ショウ)〜(よそお・う)(よそお・い)『サウ『シャウ
粧	{妝}粧。(ショウ)〜(さ)『サウ『シャウ『ソウ『よそおう
裝	〔裝〕装。(ソウ)(ショウ)〜(よそお・う)(よそお・い)『サウ『シャウ
壮	〔壯〕壮。(ソウ)〜(さかん)(つよし)『サウ
状	〔狀〕状。(ジョウ)『ジャウ
壯	〔壯〕壮。(ソウ)〜(さかん)(たけし)『サウ
狀	〔狀〕状。ジャウ『ジョウ
撞	(ドウ)(トウ)(シュ)〜(つ・く)
幢	(トウ)〜(はた)『どう『はたほこ
隹	(サイ)(スイ)〜(とり)(ふるとり)
追	(ツイ)〜(お・う)(おい)
椎	(ツイ)(スイ)〜(つち)(う・つ)(しい)『しひ
錐	(スイ)〜(きり)
騅	(スイ)〜(あしげ)
惴	(ズイ)(スイ)〜(おそ・れる)
畷	(テツ)(テイ)(セイ)〜(なわて)
墜	(ツイ)『おちる『おとす
綴	(テイ)(テツ)(テチ)(ゲツ)〜(と・じる)(つづ・る)(つづり)(すみ・やか)
縋	(ツイ)〜(すが・る)
錣	(テツ)(テイ)〜(しころ)
贅	(セイ)〜(いぼ)『ゼイ『ふすべ
肫	むむき『ももげ
諄	(シュン)〜(ひちくど・い)(くど・い)(くどくど)(ねんご・ろ)『ジュン
准	{准}準。(ジュン)『なぞらえる『みずもり
凖	(ジュン)〜(じゅん・じる)(じゅん・ずる)(なぞら・える)(のり)(ひと・しい)(みずもり)
準	{准}準。(ジュン)〜(じゅん・じる)(じゅん・ずる)(なぞら・える)(のり)(ひと・しい)(みずもり)
拙	(セツ)〜(つたな・い)『まずい
捉	(ソク)(サク)〜(とら・える)
桌	{桌}櫂。かい
倬	(タク)
灼	(シャク)〜(あらた)(やく)
卓	(タク)〜(すぐる)(たか)(たかし)『しょく
斫	(シャク)〜(き・る)
酌	(シャク)〜(く・む)
啄	(タク)(ツク)(トク)〜(ついば・む)(つつ・く)(くち)(はし)(ばし)
啅	(タク)(トウ)
琢	(タク)〜(みが・く)(あや)(たか)
濁	(ダク)(ジョク)〜(にご・る)(にご・す)(にごり)『ヂョク
擢	(テキ)(タク)〜(ぬ・く)(ぬき・んでる)
濯	(タク)〜(すす・ぐ)(ゆす・ぐ)『そそぐ
孜	(シ)〜(つと・める)
茲	(シ)(ジ)〜(ここ・に)(し・げる)『ここ
咨	(シ)〜(ああ)(はか・る)
姿	(シ)〜(すがた)(しな)
粢	(シ)〜(しとぎ)
孳	(ジ)(シ)〜(う・む)(しげ・る)
滋	(ジ)〜(し)(しげ)(しげる)
貲	(シ)〜(たから)
資	(シ)〜(すけ)(もと)『たすける『たち
緇	(シ)〜(くろ)
輜	(シ)〜(こにだ)(ほろぐるま)(にぐるま)
髭	(シ)〜(ひげ)(くちひげ)
錙	(シ)
諮	(シ)〜(はか・る)
鯔	(シ)〜(ぼら)(とど)『いな『なよし
子	(シ)(ス)(ツ)〜(こ)(こ)(ね)(い)(き)(ぎ)(く)(け)(ねっ)『み
姉	{姊}姉。(シ)〜(あね)(はは)
姊	{姊}姉。あね『シ
呰	(シ)(サ)
梓	(シ)〜(あずさ)『あづさ
䘣	ふき
紫	(シ)〜(むらさき)(さい)(ゆかり)
紫<img src="resource00513.gif">	ぜんまい
滓	(シ)(サイ)〜(おり)(か・す)
自	(ジ)(シ)〜(みずか・ら)(おの・ずから)(おの・ずと)(より)
字	(ジ)〜(あざ)(あざな)(な)
恣	(シ)〜(ほしいまま)『ほしきまま
眥	(セ)(イシ)(サイ)(シ)(セイ)〜(まなじり)(めじり)
眦	(セ)(イシ)(サイ)(シ)(セイ)〜(まなじり)(めじり)
漬	(シ)〜(つ・ける)(つ・かる)(づ・け)(づけ)『ひたす
宗	(シュウ)(ソウ)〜(むね)(かず)(し)(そ)(そお)(たか)(とし)(のり)(ひろ)(むな)(もと)(よし)『たっとぶ
棕	(シュ)(ソウ)
椶	(シュ)(ソウ)
綜	(ソウ)〜(おさ・める)(す・べる)『あぜ『ふ『へ
踪	{蹤}踪。(ソウ)(ショウ)〜(あと)
蹤	{蹤}踪。(ショウ)〜(あと)『ソウ
鑁	(バン)
偬	(ソウ)〜(くる・しむ)
揔	{揔}惣。ソウ
惣	{揔}惣。(ソウ)〜(いそが・しい)(そうじて)(ふさ)(そ)
総	〔總〕総。(ソウ)〜(す・べて)(すべ・て)(ふさ)(うさ)(ずさ)『すべる
總	〔總〕総。(ソウ)〜(す・べて)(すべ・て)(ふさ)(ずさ)『すべる
粽	(ソウ)〜(ちまき)
縦	{縱}縦。(ジュウ)〜(たて)『ショウ『たとい『ほしいまま『ほしきまま『よし『よしや
縱	{縱}縦。(ジュウ)〜(たて)『ショウ『たとい『ほしいまま『ほしきまま『よし『よしや
陬	(スウ)(シュウ)〜(すみ)
掫	(ソウ)(シュウ)〜(まも・る)(たきぎ)(う・つ)
鄒	(スウ)(シュ)(シュウ)
諏	(シュ)(ス)〜(そう)(はか・る)
赱	(ソウ)〜(はし・る)
走	(ソウ)〜(はし・る)(はしり)
奏	(ソウ)〜(かな・でる)(すすむ)『もうす
租	(ソ)『みつぎ
鉏	{鋤}鉏。さい『さひ
卆	(ソツ)(シュツ)〜(そっ・する)(お・える)(お・わる)(ついに)(にわか)
足	(ソク)〜(あし)(た・りる)(た・る)(た・す)(あ)(あす)(おす)(たらし)
卒	(ソツ)(シュツ)〜(そっ・する)(お・える)(お・わる)(ついに)(にわか)
倅	(サイ)(ソツ)(ソチ)〜(せがれ)
族	(ゾク)〜(つぎ)『ぞう『やから
鏃	(ソク)(ゾク)〜(やじり)
阻	(ソ)〜(はば・む)
岨	(ソ)(ショ)〜(いしやま)(そば)『そは『そわ
俎	(ソ)(ショ)〜(いた)(まないた)
爼	(ソ)(ショ)〜(まないた)
祖	〔祖〕祖。(ソ)〜(い)『おや
祖父	じい『じじ『ぢい『ぢぢ
祖母	うば『ばば
組	(ソ)〜(く・む)(くみ)(ぐみ)
詛	(ソ)(ショ)〜(のろ・う)
鎺	はばき
纂	(サン)〜(あつ・める)
纉	(サン)(サブ)〜(つ・ぐ)
鑚	(サン)〜(き・る)
鑽	(サン)〜(き・る)『きり『たがね
樶	(サイ)〜(ふし)
觜	(シ)(スイ)〜(くちばし)(はし)
嘴	(シ)〜(くちばし)(はし)
枠	{樺}枠。(わく)
酔	〔醉〕酔。(スイ)〜(よ・う)(よ・い)(よ)(よい)
最	(サイ)(シュ)〜(もっと・も)(つま)(も)
罪	(ザイ)〜(つみ)
醉	〔醉〕酔。(スイ)〜(よ・う)(よ・い)
尊	(ソン)〜(たっと・い)(とうと・い)(たっと・ぶ)(とうと・ぶ)(さだ)(たか)(たけ)(みこと)
墫	(シュン)
遵	(ジュン)『したがう
樽	{樽}罇。(ソン)〜(たる)『もたい『もたひ
罇	{樽}罇。もたい『もたひ
鱒	(ソン)(セン)(ザン)〜(ます)
噂	(ソン)〜(うわさ)『うはさ
昨	(サク)
筰	(サク)〜(しゃく)
左	(サ)(シャ)〜(ひだり)(そ)
佐	(サ)〜(すけ)『たすける
作	(サク)(サ)〜(つく・る)(つく・り)(づく・り)(くり)(さか)(さっ)(づくり)(とも)(なお)(はぎ)(まさか)『なす
作り皮	かは『つくりかわ
作り田	つくりだ
坐	(ザ)(サ)〜(すわ・る)(おわす)(そぞろに)(まします)『います『う
胙	(ソ)(サク)〜(ひもろぎ)
祚	(ソ)〜(くら・い)(さいわ・い)
座	(ザ)〜(すわ・る)『います『くら
做	(サ)(サク)(ソ)〜(な・す)(つく・る)
酢	(サク)〜(す)
蓙	(ザ)〜(ござ)
侮	〔侮〕侮。あなどる『ブ
僧	〔僧〕僧。ソウ
免	〔免〕免。まぬかれる『メン
勉	〔勉〕勉。ベン
勤	〔勤〕勤。キン『ゴン『つとまる『つとめる
匁	{兩}匁。(もんめ)(め)(ひゃくめ)『もんめ
卑	〔卑〕卑。いやしい『いやしむ『いやしめる『ヒ
喝	〔喝〕喝。カツ
嘆	〔嘆〕嘆。タン『なげかわしい『なげく
器	〔器〕器。うつわ『キ
塀	〔塀〕塀。ヘイ
塚	{冢}塚。つか
墨	〔墨〕墨。すみ『ボク
層	〔層〕層。ソウ
岾	(やま)
悔	〔悔〕悔。カイ『くいる『くやしい『くやむ
慨	〔慨〕慨。ガイ
憎	〔憎〕憎。ゾウ『にくい『にくしみ『にくむ『にくらしい
懲	〔懲〕懲。こらしめる『こらす『こりる『チョウ
敏	〔敏〕敏。ビン
既	〔既〕既。キ『すでに
暑	〔暑〕暑。あつい『ショ
桛	かせ
梅	〔梅〕梅。うめ『バイ
海	〔海〕海。うみ『カイ
漢	〔漢〕漢。カン
煮	〔煮〕煮。シャ『にえる『にやす『にる
瓱	(ミリグラム)
益	〔益〕益。エキ『ヤク
碑	〔碑〕碑。ヒ
社	〔社〕社。シャ『やしろ
祈	〔祈〕祈。いのる『キ
祉	〔祉〕祉。シ
祖	〔祖〕祖。ソ
祝	〔祝〕祝。いわう『シュウ『シュク
神	〔神〕神。かみ『かん『こう『シン『ジン
祥	〔祥〕祥。ショウ
禍	〔禍〕禍。カ
福	〔福〕福。フク
穀	〔穀〕穀。コク
突	〔突〕突。つく『トツ
節	〔節〕節。セチ『セツ『ふし
練	〔練〕練。ねる『レン
繁	〔繁〕繁。ハン
署	〔署〕署。ショ
羽	〔羽〕羽。ウ『は『はね
者	〔者〕者。シャ『もの
臭	〔臭〕臭。くさい『シュウ『におう
著	〔著〕著。あらわす『いちじるしい『チョ
﨟	ラフ『ろう
袰	(ほろ)
褐	〔褐〕褐。カツ
視	〔視〕視。シ
諸	〔諸〕諸。ショ
謁	〔謁〕謁。エツ
謹	〔謹〕謹。キン『つつしむ
賓	〔賓〕賓。ヒン
贈	〔贈〕贈。おくる『ソウ『ゾウ
逸	〔逸〕逸。イツ
都	〔都〕都。ツ『ト『みやこ
難	〔難〕難。かたい『ナン『むずかしい
響	〔響〕響。キョウ『ひびく
頻	〔頻〕頻。ヒン
館	〔館〕館。カン『やかた
𡑮	そく
𩺊	あら
沿	〔沿〕沿。エン『そう
々	(くりかえし)
ヽ	(くりかえし)
ヾ	(くりかえし)
ゝ	(くりかえし)
ゞ	(くりかえし)
ー	(ちょうおん)
〃	(おなじく)
〆	(しめ)
